date,dailyCases,smoothedCases,cumulativeCases,Population,peak
2020-02-25,1,1,1,2065647,1
2020-02-26,0,0,1,2065647,1
2020-02-27,0,0,1,2065647,1
2020-02-28,0,0,1,2065647,1
2020-02-29,0,0,1,2065647,1
2020-03-01,0,0,1,2065647,1
2020-03-02,2,0,1,2065647,1
2020-03-03,0,0,1,2065647,1
2020-03-04,0,0,1,2065647,1
2020-03-05,0,0,1,2065647,1
2020-03-06,0,0,1,2065647,1
2020-03-07,0,0,1,2065647,1
2020-03-08,1,0,1,2065647,1
2020-03-09,1,0,1,2065647,1
2020-03-10,2,1,2,2065647,1
2020-03-11,3,1,3,2065647,1
2020-03-12,3,1,4,2065647,1
2020-03-13,2,2,6,2065647,1
2020-03-14,5,2,8,2065647,1
2020-03-15,6,3,11,2065647,1
2020-03-16,5,4,15,2065647,1
2020-03-17,7,4,19,2065647,1
2020-03-18,6,5,24,2065647,1
2020-03-19,36,10,34,2065647,1
2020-03-20,49,16,50,2065647,1
2020-03-21,90,28,78,2065647,1
2020-03-22,90,40,118,2065647,1
2020-03-23,133,59,177,2065647,1
2020-03-24,144,78,255,2065647,1
2020-03-25,187,104,359,2065647,1
2020-03-26,180,125,484,2065647,1
2020-03-27,243,152,636,2065647,1
2020-03-28,200,168,804,2065647,1
2020-03-29,259,192,996,2065647,1
2020-03-30,266,211,1207,2065647,1
2020-03-31,331,238,1445,2065647,1
2020-04-01,305,255,1700,2065647,1
2020-04-02,408,287,1987,2065647,1
2020-04-03,348,302,2289,2065647,1
2020-04-04,340,322,2611,2065647,1
2020-04-05,261,323,2934,2065647,1
2020-04-06,456,350,3284,2065647,1
2020-04-07,423,363,3647,2065647,1
2020-04-08,374,373,4020,2065647,1
2020-04-09,350,365,4385,2065647,1
2020-04-10,305,358,4743,2065647,1
2020-04-11,264,348,5091,2065647,1
2020-04-12,329,357,5448,2065647,1
2020-04-13,542,370,5818,2065647,1
2020-04-14,469,376,6194,2065647,1
2020-04-15,613,410,6604,2065647,1
2020-04-16,497,431,7035,2065647,1
2020-04-17,571,469,7504,2065647,1
2020-04-18,329,479,7983,2065647,1
2020-04-19,432,493,8476,2065647,1
2020-04-20,481,485,8961,2065647,1
2020-04-21,461,483,9444,2065647,1
2020-04-22,536,472,9916,2065647,1
2020-04-23,530,477,10393,2065647,1
2020-04-24,495,466,10859,2065647,1
2020-04-25,318,465,11324,2065647,1
2020-04-26,287,444,11768,2065647,1
2020-04-27,462,441,12209,2065647,1
2020-04-28,475,443,12652,2065647,1
2020-04-29,522,441,13093,2065647,1
2020-04-30,587,449,13542,2065647,1
2020-05-01,621,467,14009,2065647,1
2020-05-02,525,497,14506,2065647,1
2020-05-03,345,505,15011,2065647,1
2020-05-04,422,500,15511,2065647,1
2020-05-05,471,499,16010,2065647,1
2020-05-06,568,506,16516,2065647,1
2020-05-07,431,483,16999,2065647,1
2020-05-08,433,456,17455,2065647,1
2020-05-09,314,426,17881,2065647,1
2020-05-10,299,420,18301,2065647,1
2020-05-11,363,411,18712,2065647,1
2020-05-12,430,405,19117,2065647,1
2020-05-13,402,382,19499,2065647,1
2020-05-14,354,371,19870,2065647,1
2020-05-15,346,358,20228,2065647,1
2020-05-16,272,352,20580,2065647,1
2020-05-17,336,358,20938,2065647,1
2020-05-18,332,353,21291,2065647,1
2020-05-19,316,337,21628,2065647,1
2020-05-20,408,338,21966,2065647,1
2020-05-21,380,341,22307,2065647,1
2020-05-22,254,328,22635,2065647,1
2020-05-23,218,321,22956,2065647,1
2020-05-24,215,303,23259,2065647,1
2020-05-25,208,286,23545,2065647,1
2020-05-26,240,275,23820,2065647,1
2020-05-27,254,253,24073,2065647,1
2020-05-28,194,226,24299,2065647,1
2020-05-29,194,218,24517,2065647,1
2020-05-30,206,216,24733,2065647,1
2020-05-31,140,205,24938,2065647,1
2020-06-01,159,198,25136,2065647,1
2020-06-02,97,178,25314,2065647,1
2020-06-03,115,158,25472,2065647,1
2020-06-04,129,149,25621,2065647,1
2020-06-05,107,136,25757,2065647,1
2020-06-06,104,122,25879,2065647,1
2020-06-07,76,112,25991,2065647,1
2020-06-08,51,97,26088,2065647,1
2020-06-09,80,95,26183,2065647,1
2020-06-10,66,88,26271,2065647,1
2020-06-11,66,79,26350,2065647,1
2020-06-12,72,74,26424,2065647,1
2020-06-13,67,68,26492,2065647,1
2020-06-14,28,61,26553,2065647,1
2020-06-15,56,62,26615,2065647,1
2020-06-16,73,61,26676,2065647,1
2020-06-17,52,59,26735,2065647,1
2020-06-18,49,57,26792,2065647,1
2020-06-19,65,56,26848,2065647,1
2020-06-20,33,51,26899,2065647,1
2020-06-21,26,51,26950,2065647,1
2020-06-22,39,48,26998,2065647,1
2020-06-23,40,43,27041,2065647,1
2020-06-24,28,40,27081,2065647,1
2020-06-25,47,40,27121,2065647,1
2020-06-26,42,36,27157,2065647,1
2020-06-27,30,36,27193,2065647,1
2020-06-28,18,35,27228,2065647,1
2020-06-29,16,32,27260,2065647,1
2020-06-30,40,32,27292,2065647,1
2020-07-01,23,31,27323,2065647,1
2020-07-02,17,27,27350,2065647,1
2020-07-03,18,23,27373,2065647,1
2020-07-04,15,21,27394,2065647,1
2020-07-05,7,19,27413,2065647,1
2020-07-06,16,19,27432,2065647,1
2020-07-07,21,17,27449,2065647,1
2020-07-08,33,18,27467,2065647,NA
2020-07-09,52,23,27490,2065647,NA
2020-07-10,48,27,27517,2065647,NA
2020-07-11,22,28,27545,2065647,NA
2020-07-12,13,29,27574,2065647,NA
2020-07-13,76,38,27612,2065647,NA
2020-07-14,66,44,27656,2065647,NA
2020-07-15,69,49,27705,2065647,NA
2020-07-16,68,52,27757,2065647,NA
2020-07-17,100,59,27816,2065647,NA
2020-07-18,98,70,27886,2065647,NA
2020-07-19,54,76,27962,2065647,NA
2020-07-20,37,70,28032,2065647,NA
2020-07-21,65,70,28102,2065647,NA
2020-07-22,78,71,28173,2065647,NA
2020-07-23,98,76,28249,2065647,NA
2020-07-24,69,71,28320,2065647,NA
2020-07-25,32,62,28382,2065647,NA
2020-07-26,52,62,28444,2065647,NA
2020-07-27,40,62,28506,2065647,NA
2020-07-28,37,58,28564,2065647,NA
2020-07-29,70,57,28621,2065647,NA
2020-07-30,60,51,28672,2065647,NA
2020-07-31,57,50,28722,2065647,NA
2020-08-01,51,52,28774,2065647,NA
2020-08-02,30,49,28823,2065647,NA
2020-08-03,45,50,28873,2065647,NA
2020-08-04,64,54,28927,2065647,NA
2020-08-05,47,51,28978,2065647,NA
2020-08-06,21,45,29023,2065647,NA
2020-08-07,46,43,29066,2065647,NA
2020-08-08,37,41,29107,2065647,NA
2020-08-09,36,42,29149,2065647,NA
2020-08-10,34,41,29190,2065647,NA
2020-08-11,36,37,29227,2065647,NA
2020-08-12,34,35,29262,2065647,NA
2020-08-13,38,37,29299,2065647,NA
2020-08-14,30,35,29334,2065647,NA
2020-08-15,14,32,29366,2065647,NA
2020-08-16,12,28,29394,2065647,NA
2020-08-17,17,26,29420,2065647,NA
2020-08-18,16,23,29443,2065647,NA
2020-08-19,22,21,29464,2065647,NA
2020-08-20,34,21,29485,2065647,NA
2020-08-21,33,21,29506,2065647,NA
2020-08-22,20,22,29528,2065647,NA
2020-08-23,23,24,29552,2065647,NA
2020-08-24,10,23,29575,2065647,NA
2020-08-25,30,25,29600,2065647,NA
2020-08-26,42,27,29627,2065647,NA
2020-08-27,43,29,29656,2065647,NA
2020-08-28,24,27,29683,2065647,NA
2020-08-29,55,32,29715,2065647,NA
2020-08-30,13,31,29746,2065647,NA
2020-08-31,32,34,29780,2065647,NA
2020-09-01,35,35,29815,2065647,2
2020-09-02,36,34,29849,2065647,2
2020-09-03,70,38,29887,2065647,2
2020-09-04,49,41,29928,2065647,2
2020-09-05,67,43,29971,2065647,2
2020-09-06,59,50,30021,2065647,2
2020-09-07,51,52,30073,2065647,2
2020-09-08,72,58,30131,2065647,2
2020-09-09,70,63,30194,2065647,2
2020-09-10,89,65,30259,2065647,2
2020-09-11,108,74,30333,2065647,2
2020-09-12,71,74,30407,2065647,2
2020-09-13,96,80,30487,2065647,2
2020-09-14,73,83,30570,2065647,2
2020-09-15,94,86,30656,2065647,2
2020-09-16,79,87,30743,2065647,2
2020-09-17,71,85,30828,2065647,2
2020-09-18,200,98,30926,2065647,2
2020-09-19,139,107,31033,2065647,2
2020-09-20,204,123,31156,2065647,2
2020-09-21,141,133,31289,2065647,2
2020-09-22,169,143,31432,2065647,2
2020-09-23,254,168,31600,2065647,2
2020-09-24,231,191,31791,2065647,2
2020-09-25,288,204,31995,2065647,2
2020-09-26,343,233,32228,2065647,2
2020-09-27,276,243,32471,2065647,2
2020-09-28,282,263,32734,2065647,2
2020-09-29,354,290,33024,2065647,2
2020-09-30,315,298,33322,2065647,2
2020-10-01,308,309,33631,2065647,2
2020-10-02,415,328,33959,2065647,2
2020-10-03,372,332,34291,2065647,2
2020-10-04,304,336,34627,2065647,2
2020-10-05,280,335,34962,2065647,2
2020-10-06,257,322,35284,2065647,2
2020-10-07,297,319,35603,2065647,2
2020-10-08,346,324,35927,2065647,2
2020-10-09,286,306,36233,2065647,2
2020-10-10,193,280,36513,2065647,2
2020-10-11,329,284,36797,2065647,2
2020-10-12,267,282,37079,2065647,2
2020-10-13,203,274,37353,2065647,2
2020-10-14,270,271,37624,2065647,2
2020-10-15,256,258,37882,2065647,2
2020-10-16,264,255,38137,2065647,2
2020-10-17,272,266,38403,2065647,2
2020-10-18,194,247,38650,2065647,2
2020-10-19,241,243,38893,2065647,2
2020-10-20,253,250,39143,2065647,2
2020-10-21,287,252,39395,2065647,2
2020-10-22,226,248,39643,2065647,2
2020-10-23,246,246,39889,2065647,2
2020-10-24,166,230,40119,2065647,2
2020-10-25,219,234,40353,2065647,2
2020-10-26,354,250,40603,2065647,2
2020-10-27,245,249,40852,2065647,2
2020-10-28,208,238,41090,2065647,2
2020-10-29,219,237,41327,2065647,2
2020-10-30,198,230,41557,2065647,2
2020-10-31,240,240,41797,2065647,2
2020-11-01,235,243,42040,2065647,2
2020-11-02,198,220,42260,2065647,2
2020-11-03,238,219,42479,2065647,2
2020-11-04,247,225,42704,2065647,2
2020-11-05,326,240,42944,2065647,2
2020-11-06,264,250,43194,2065647,2
2020-11-07,271,254,43448,2065647,2
2020-11-08,275,260,43708,2065647,2
2020-11-09,266,270,43978,2065647,2
2020-11-10,319,281,44259,2065647,2
2020-11-11,347,295,44554,2065647,2
2020-11-12,283,289,44843,2065647,2
2020-11-13,328,298,45141,2065647,2
2020-11-14,303,303,45444,2065647,2
2020-11-15,277,303,45747,2065647,2
2020-11-16,309,309,46056,2065647,2
2020-11-17,241,298,46354,2065647,2
2020-11-18,232,282,46636,2065647,2
2020-11-19,283,282,46918,2065647,2
2020-11-20,253,271,47189,2065647,2
2020-11-21,268,266,47455,2065647,2
2020-11-22,300,269,47724,2065647,2
2020-11-23,275,265,47989,2065647,2
2020-11-24,237,264,48253,2065647,2
2020-11-25,303,274,48527,2065647,2
2020-11-26,347,283,48810,2065647,2
2020-11-27,416,307,49117,2065647,2
2020-11-28,446,332,49449,2065647,2
2020-11-29,364,341,49790,2065647,2
2020-11-30,333,349,50139,2065647,2
2020-12-01,418,375,50514,2065647,2
2020-12-02,457,397,50911,2065647,2
2020-12-03,452,412,51323,2065647,2
2020-12-04,500,424,51747,2065647,2
2020-12-05,518,435,52182,2065647,2
2020-12-06,482,451,52633,2065647,2
2020-12-07,461,470,53103,2065647,2
2020-12-08,531,486,53589,2065647,2
2020-12-09,590,505,54094,2065647,2
2020-12-10,548,519,54613,2065647,2
2020-12-11,646,539,55152,2065647,2
2020-12-12,730,570,55722,2065647,2
2020-12-13,564,581,56303,2065647,2
2020-12-14,678,612,56915,2065647,2
2020-12-15,554,616,57531,2065647,2
2020-12-16,701,632,58163,2065647,2
2020-12-17,929,686,58849,2065647,2
2020-12-18,812,710,59559,2065647,2
2020-12-19,699,705,60264,2065647,2
2020-12-20,652,718,60982,2065647,2
2020-12-21,755,729,61711,2065647,2
2020-12-22,760,758,62469,2065647,2
2020-12-23,701,758,63227,2065647,2
2020-12-24,878,751,63978,2065647,2
2020-12-25,945,770,64748,2065647,2
2020-12-26,756,778,65526,2065647,2
2020-12-27,802,800,66326,2065647,2
2020-12-28,843,812,67138,2065647,2
2020-12-29,999,846,67984,2065647,2
2020-12-30,933,879,68863,2065647,2
2020-12-31,743,860,69723,2065647,2
2021-01-01,1231,901,70624,2065647,2
2021-01-02,924,925,71549,2065647,2
2021-01-03,791,923,72472,2065647,2
2021-01-04,770,913,73385,2065647,2
2021-01-05,822,888,74273,2065647,2
2021-01-06,1094,911,75184,2065647,2
2021-01-07,1278,987,76171,2065647,2
2021-01-08,1047,961,77132,2065647,2
2021-01-09,820,946,78078,2065647,2
2021-01-10,778,944,79022,2065647,2
2021-01-11,565,915,79937,2065647,2
2021-01-12,861,920,80857,2065647,2
2021-01-13,731,869,81726,2065647,2
2021-01-14,818,803,82529,2065647,2
2021-01-15,714,755,83284,2065647,2
2021-01-16,880,764,84048,2065647,2
2021-01-17,582,736,84784,2065647,2
2021-01-18,471,722,85506,2065647,2
2021-01-19,638,691,86197,2065647,2
2021-01-20,671,682,86879,2065647,2
2021-01-21,765,674,87553,2065647,2
2021-01-22,616,660,88213,2065647,2
2021-01-23,563,615,88828,2065647,2
2021-01-24,430,593,89421,2065647,2
2021-01-25,506,598,90019,2065647,2
2021-01-26,595,592,90611,2065647,2
2021-01-27,455,561,91172,2065647,2
2021-01-28,574,534,91706,2065647,2
2021-01-29,499,517,92223,2065647,2
2021-01-30,558,517,92740,2065647,2
2021-01-31,389,511,93251,2065647,2
2021-02-01,470,506,93757,2065647,2
2021-02-02,561,501,94258,2065647,2
2021-02-03,485,505,94763,2065647,2
2021-02-04,526,498,95261,2065647,2
2021-02-05,554,506,95767,2065647,2
2021-02-06,509,499,96266,2065647,2
2021-02-07,406,502,96768,2065647,2
2021-02-08,333,482,97250,2065647,2
2021-02-09,450,466,97716,2065647,2
2021-02-10,549,475,98191,2065647,2
2021-02-11,474,468,98659,2065647,2
2021-02-12,485,458,99117,2065647,2
2021-02-13,344,434,99551,2065647,2
2021-02-14,351,427,99978,2065647,2
2021-02-15,322,425,100403,2065647,2
2021-02-16,410,419,100822,2065647,2
2021-02-17,332,388,101210,2065647,2
2021-02-18,377,374,101584,2065647,2
2021-02-19,395,362,101946,2065647,2
2021-02-20,390,368,102314,2065647,2
2021-02-21,405,376,102690,2065647,2
2021-02-22,263,367,103057,2065647,2
2021-02-23,421,369,103426,2065647,2
2021-02-24,408,380,103806,2065647,2
2021-02-25,388,381,104187,2065647,2
2021-02-26,400,382,104569,2065647,2
2021-02-27,324,373,104942,2065647,2
2021-02-28,249,350,105292,2065647,2
2021-03-01,258,350,105642,2065647,2
2021-03-02,392,346,105988,2065647,2
2021-03-03,303,331,106319,2065647,2
2021-03-04,375,329,106648,2065647,2
2021-03-05,280,312,106960,2065647,2
2021-03-06,398,322,107282,2065647,2
2021-03-07,267,325,107607,2065647,2
2021-03-08,259,325,107932,2065647,2
2021-03-09,392,325,108257,2065647,2
2021-03-10,316,327,108584,2065647,2
2021-03-11,362,325,108909,2065647,2
2021-03-12,390,341,109250,2065647,2
2021-03-13,277,323,109573,2065647,2
2021-03-14,271,324,109897,2065647,2
2021-03-15,244,322,110219,2065647,2
2021-03-16,339,314,110533,2065647,2
2021-03-17,315,314,110847,2065647,2
2021-03-18,357,313,111160,2065647,2
2021-03-19,319,303,111463,2065647,2
2021-03-20,267,302,111765,2065647,2
2021-03-21,307,307,112072,2065647,2
2021-03-22,226,304,112376,2065647,2
2021-03-23,339,304,112680,2065647,2
2021-03-24,367,312,112992,2065647,2
2021-03-25,354,311,113303,2065647,2
2021-03-26,361,317,113620,2065647,2
2021-03-27,310,323,113943,2065647,2
2021-03-28,262,317,114260,2065647,2
2021-03-29,306,328,114588,2065647,2
2021-03-30,379,334,114922,2065647,2
2021-03-31,402,339,115261,2065647,2
2021-04-01,359,340,115601,2065647,2
2021-04-02,386,343,115944,2065647,2
2021-04-03,356,350,116294,2065647,2
2021-04-04,302,356,116650,2065647,2
2021-04-05,293,354,117004,2065647,2
2021-04-06,311,344,117348,2065647,2
2021-04-07,406,345,117693,2065647,2
2021-04-08,394,350,118043,2065647,2
2021-04-09,517,368,118411,2065647,2
2021-04-10,296,360,118771,2065647,2
2021-04-11,378,371,119142,2065647,2
2021-04-12,261,366,119508,2065647,2
2021-04-13,372,375,119883,2065647,2
2021-04-14,354,367,120250,2065647,2
2021-04-15,431,373,120623,2065647,2
2021-04-16,366,351,120974,2065647,2
2021-04-17,351,359,121333,2065647,2
2021-04-18,217,336,121669,2065647,2
2021-04-19,253,335,122004,2065647,2
2021-04-20,273,321,122325,2065647,2
2021-04-21,311,315,122640,2065647,2
2021-04-22,315,298,122938,2065647,2
2021-04-23,229,278,123216,2065647,2
2021-04-24,341,277,123493,2065647,2
2021-04-25,198,274,123767,2065647,2
2021-04-26,244,273,124040,2065647,2
2021-04-27,292,276,124316,2065647,2
2021-04-28,311,276,124592,2065647,2
2021-04-29,343,280,124872,2065647,2
2021-04-30,323,293,125165,2065647,2
2021-05-01,262,282,125447,2065647,2
2021-05-02,210,284,125731,2065647,2
2021-05-03,224,281,126012,2065647,2
2021-05-04,238,273,126285,2065647,2
2021-05-05,199,257,126542,2065647,2
2021-05-06,259,245,126787,2065647,2
2021-05-07,279,239,127026,2065647,2
2021-05-08,212,232,127258,2065647,2
2021-05-09,196,230,127488,2065647,2
2021-05-10,189,225,127713,2065647,2
2021-05-11,261,228,127941,2065647,2
2021-05-12,261,237,128178,2065647,2
2021-05-13,291,241,128419,2065647,2
2021-05-14,243,236,128655,2065647,2
2021-05-15,206,235,128890,2065647,2
2021-05-16,185,234,129124,2065647,2
2021-05-17,191,234,129358,2065647,2
2021-05-18,206,226,129584,2065647,2
2021-05-19,263,226,129810,2065647,2
2021-05-20,247,220,130030,2065647,2
2021-05-21,197,214,130244,2065647,2
2021-05-22,181,210,130454,2065647,2
2021-05-23,114,200,130654,2065647,2
2021-05-24,155,195,130849,2065647,2
2021-05-25,164,189,131038,2065647,2
2021-05-26,154,173,131211,2065647,2
2021-05-27,147,159,131370,2065647,2
2021-05-28,142,151,131521,2065647,2
2021-05-29,83,137,131658,2065647,2
2021-05-30,80,132,131790,2065647,2
2021-05-31,83,122,131912,2065647,2
2021-06-01,107,114,132026,2065647,2
2021-06-02,99,106,132132,2065647,2
2021-06-03,84,97,132229,2065647,2
2021-06-04,87,89,132318,2065647,2
2021-06-05,73,88,132406,2065647,2
2021-06-06,49,83,132489,2065647,2
2021-06-07,60,80,132569,2065647,2
2021-06-08,56,73,132642,2065647,2
2021-06-09,42,64,132706,2065647,2
2021-06-10,64,62,132768,2065647,2
2021-06-11,67,59,132827,2065647,2
2021-06-12,51,56,132883,2065647,2
2021-06-13,35,54,132937,2065647,2
2021-06-14,36,50,132987,2065647,2
2021-06-15,62,51,133038,2065647,2
2021-06-16,45,51,133089,2065647,2
2021-06-17,57,50,133139,2065647,2
2021-06-18,50,48,133187,2065647,2
2021-06-19,24,44,133231,2065647,2
2021-06-20,27,43,133274,2065647,2
2021-06-21,28,42,133316,2065647,2
2021-06-22,46,40,133356,2065647,2
2021-06-23,28,37,133393,2065647,2
2021-06-24,27,33,133426,2065647,2
2021-06-25,35,31,133457,2065647,2
2021-06-26,35,32,133489,2065647,2
2021-06-27,13,30,133519,2065647,2
2021-06-28,38,32,133551,2065647,2
2021-06-29,40,31,133582,2065647,2
2021-06-30,26,31,133613,2065647,2
2021-07-01,25,30,133643,2065647,3
2021-07-02,26,29,133672,2065647,3
2021-07-03,23,27,133699,2065647,3
2021-07-04,12,27,133726,2065647,3
2021-07-05,22,25,133751,2065647,3
2021-07-06,30,23,133774,2065647,3
2021-07-07,29,24,133798,2065647,3
2021-07-08,33,25,133823,2065647,3
2021-07-09,25,25,133848,2065647,3
2021-07-10,18,24,133872,2065647,3
2021-07-11,20,25,133897,2065647,3
2021-07-12,27,26,133923,2065647,3
2021-07-13,31,26,133949,2065647,3
2021-07-14,32,27,133976,2065647,3
2021-07-15,40,28,134004,2065647,3
2021-07-16,30,28,134032,2065647,3
2021-07-17,32,30,134062,2065647,3
2021-07-18,35,32,134094,2065647,3
2021-07-19,28,33,134127,2065647,3
2021-07-20,54,36,134163,2065647,3
2021-07-21,53,39,134202,2065647,3
2021-07-22,49,40,134242,2065647,3
2021-07-23,46,42,134284,2065647,3
2021-07-24,33,43,134327,2065647,3
2021-07-25,35,43,134370,2065647,3
2021-07-26,40,44,134414,2065647,3
2021-07-27,52,44,134458,2065647,3
2021-07-28,48,43,134501,2065647,3
2021-07-29,16,39,134540,2065647,3
2021-07-30,106,47,134587,2065647,3
2021-07-31,52,50,134637,2065647,3
2021-08-01,43,51,134688,2065647,3
2021-08-02,54,53,134741,2065647,3
2021-08-03,52,53,134794,2065647,3
2021-08-04,94,60,134854,2065647,3
2021-08-05,103,72,134926,2065647,3
2021-08-06,93,70,134996,2065647,3
2021-08-07,86,75,135071,2065647,3
2021-08-08,69,79,135150,2065647,3
2021-08-09,85,83,135233,2065647,3
2021-08-10,105,91,135324,2065647,3
2021-08-11,152,99,135423,2065647,3
2021-08-12,143,105,135528,2065647,3
2021-08-13,158,114,135642,2065647,3
2021-08-14,142,122,135764,2065647,3
2021-08-15,135,131,135895,2065647,3
2021-08-16,138,139,136034,2065647,3
2021-08-17,148,145,136179,2065647,3
2021-08-18,201,152,136331,2065647,3
2021-08-19,179,157,136488,2065647,3
2021-08-20,209,165,136653,2065647,3
2021-08-21,157,167,136820,2065647,3
2021-08-22,129,166,136986,2065647,3
2021-08-23,161,169,137155,2065647,3
2021-08-24,216,179,137334,2065647,3
2021-08-25,225,182,137516,2065647,3
2021-08-26,248,192,137708,2065647,3
2021-08-27,200,191,137899,2065647,3
2021-08-28,154,190,138089,2065647,3
2021-08-29,133,191,138280,2065647,3
2021-08-30,181,194,138474,2065647,3
2021-08-31,246,198,138672,2065647,3
2021-09-01,274,205,138877,2065647,3
2021-09-02,245,205,139082,2065647,3
2021-09-03,249,212,139294,2065647,3
2021-09-04,204,219,139513,2065647,3
2021-09-05,191,227,139740,2065647,3
2021-09-06,182,227,139967,2065647,3
2021-09-07,202,221,140188,2065647,3
2021-09-08,237,216,140404,2065647,3
2021-09-09,315,226,140630,2065647,3
2021-09-10,286,231,140861,2065647,3
2021-09-11,236,236,141097,2065647,3
2021-09-12,205,238,141335,2065647,3
2021-09-13,234,245,141580,2065647,3
2021-09-14,248,252,141832,2065647,3
2021-09-15,319,263,142095,2065647,3
2021-09-16,284,259,142354,2065647,3
2021-09-17,266,256,142610,2065647,3
2021-09-18,261,260,142870,2065647,3
2021-09-19,213,261,143131,2065647,3
2021-09-20,206,257,143388,2065647,3
2021-09-21,227,254,143642,2065647,3
2021-09-22,251,244,143886,2065647,3
2021-09-23,210,233,144119,2065647,3
2021-09-24,268,234,144353,2065647,3
2021-09-25,209,226,144579,2065647,3
2021-09-26,137,215,144794,2065647,3
2021-09-27,140,206,145000,2065647,3
2021-09-28,188,200,145200,2065647,3
2021-09-29,234,198,145398,2065647,3
2021-09-30,189,195,145593,2065647,3
2021-10-01,149,178,145771,2065647,3
2021-10-02,119,165,145936,2065647,3
2021-10-03,128,164,146100,2065647,3
2021-10-04,119,161,146261,2065647,3
2021-10-05,130,153,146414,2065647,3
2021-10-06,161,142,146556,2065647,3
2021-10-07,175,140,146696,2065647,3
2021-10-08,155,141,146837,2065647,3
2021-10-09,153,146,146983,2065647,3
2021-10-10,91,141,147124,2065647,3
2021-10-11,129,142,147266,2065647,3
2021-10-12,157,146,147412,2065647,3
2021-10-13,145,144,147556,2065647,3
2021-10-14,193,146,147702,2065647,3
2021-10-15,208,154,147856,2065647,3
2021-10-16,141,152,148008,2065647,3
2021-10-17,95,153,148161,2065647,3
2021-10-18,122,152,148313,2065647,3
2021-10-19,119,146,148459,2065647,3
2021-10-20,141,146,148605,2065647,3
2021-10-21,89,131,148736,2065647,3
2021-10-22,120,118,148854,2065647,3
2021-10-23,99,112,148966,2065647,3
2021-10-24,102,113,149079,2065647,3
2021-10-25,103,110,149189,2065647,3
2021-10-26,147,114,149303,2065647,3
2021-10-27,141,114,149417,2065647,3
2021-10-28,168,126,149543,2065647,3
2021-10-29,138,128,149671,2065647,3
2021-10-30,143,135,149806,2065647,3
2021-10-31,141,140,149946,2065647,3
2021-11-01,123,143,150089,2065647,4
2021-11-02,111,138,150227,2065647,4
2021-11-03,164,141,150368,2065647,4
2021-11-04,153,139,150507,2065647,4
2021-11-05,165,143,150650,2065647,4
2021-11-06,204,152,150802,2065647,4
2021-11-07,179,157,150959,2065647,4
2021-11-08,152,161,151120,2065647,4
2021-11-09,234,179,151299,2065647,4
2021-11-10,213,186,151485,2065647,4
2021-11-11,197,192,151677,2065647,4
2021-11-12,188,195,151872,2065647,4
2021-11-13,168,190,152062,2065647,4
2021-11-14,141,185,152247,2065647,4
2021-11-15,135,182,152429,2065647,4
2021-11-16,268,187,152616,2065647,4
2021-11-17,238,191,152807,2065647,4
2021-11-18,191,190,152997,2065647,4
2021-11-19,256,200,153197,2065647,4
2021-11-20,206,205,153402,2065647,4
2021-11-21,216,216,153618,2065647,4
2021-11-22,179,222,153840,2065647,4
2021-11-23,239,218,154058,2065647,4
2021-11-24,302,227,154285,2065647,4
2021-11-25,302,243,154528,2065647,4
2021-11-26,244,241,154769,2065647,4
2021-11-27,219,243,155012,2065647,4
2021-11-28,227,245,155257,2065647,4
2021-11-29,291,261,155518,2065647,4
2021-11-30,340,275,155793,2065647,4
2021-12-01,386,287,156080,2065647,4
2021-12-02,409,302,156382,2065647,4
2021-12-03,383,322,156704,2065647,4
2021-12-04,389,346,157050,2065647,4
2021-12-05,342,363,157413,2065647,4
2021-12-06,345,371,157784,2065647,4
2021-12-07,403,380,158164,2065647,4
2021-12-08,498,396,158560,2065647,4
2021-12-09,557,417,158977,2065647,4
2021-12-10,547,440,159417,2065647,4
2021-12-11,448,449,159866,2065647,4
2021-12-12,413,459,160325,2065647,4
2021-12-13,725,513,160838,2065647,4
2021-12-14,916,586,161424,2065647,4
2021-12-15,965,653,162077,2065647,4
2021-12-16,1145,737,162814,2065647,4
2021-12-17,1162,825,163639,2065647,4
2021-12-18,1606,990,164629,2065647,4
2021-12-19,1410,1133,165762,2065647,4
2021-12-20,2020,1318,167080,2065647,4
2021-12-21,2436,1535,168615,2065647,4
2021-12-22,3348,1875,170490,2065647,4
2021-12-23,3330,2187,172677,2065647,4
2021-12-24,3404,2508,175185,2065647,4
2021-12-25,3069,2717,177902,2065647,4
2021-12-26,3006,2945,180847,2065647,4
2021-12-27,3964,3222,184069,2065647,4
2021-12-28,4669,3541,187610,2065647,4
2021-12-29,4629,3724,191334,2065647,4
2021-12-30,4467,3887,195221,2065647,4
2021-12-31,4030,3976,199197,2065647,4
2022-01-01,3703,4067,203264,2065647,4
2022-01-02,3884,4192,207456,2065647,4
2022-01-03,3673,4151,211607,2065647,4
2022-01-04,4519,4129,215736,2065647,4
2022-01-05,4482,4108,219844,2065647,4
2022-01-06,3828,4017,223861,2065647,4
2022-01-07,3231,3903,227764,2065647,4
2022-01-08,2525,3735,231499,2065647,4
2022-01-09,3255,3645,235144,2065647,4
2022-01-10,3324,3595,238739,2065647,4
2022-01-11,2188,3262,242001,2065647,4
2022-01-12,2043,2913,244914,2065647,4
2022-01-13,1957,2646,247560,2065647,4
2022-01-14,1734,2432,249992,2065647,4
2022-01-15,1329,2261,252253,2065647,4
2022-01-16,1181,1965,254218,2065647,4
2022-01-17,974,1629,255847,2065647,4
2022-01-18,1449,1524,257371,2065647,4
2022-01-19,1210,1405,258776,2065647,4
2022-01-20,1141,1288,260064,2065647,4
2022-01-21,1041,1189,261253,2065647,4
2022-01-22,647,1092,262345,2065647,4
2022-01-23,519,997,263342,2065647,4
2022-01-24,801,973,264315,2065647,4
2022-01-25,760,874,265189,2065647,4
2022-01-26,776,812,266001,2065647,4
2022-01-27,612,737,266738,2065647,4
2022-01-28,600,674,267412,2065647,4
2022-01-29,578,664,268076,2065647,4
2022-01-30,379,644,268720,2065647,4
2022-01-31,578,612,269332,2065647,4
2022-02-01,684,601,269933,2065647,4
2022-02-02,743,596,270529,2065647,4
2022-02-03,622,598,271127,2065647,4
2022-02-04,522,587,271714,2065647,4
2022-02-05,339,552,272266,2065647,4
2022-02-06,330,545,272811,2065647,4
2022-02-07,611,550,273361,2065647,4
2022-02-08,543,530,273891,2065647,4
2022-02-09,454,489,274380,2065647,4
2022-02-10,479,468,274848,2065647,4
2022-02-11,529,469,275317,2065647,4
2022-02-12,242,455,275772,2065647,4
2022-02-13,248,444,276216,2065647,4
2022-02-14,379,411,276627,2065647,4
2022-02-15,338,381,277008,2065647,4
2022-02-16,320,362,277370,2065647,4
2022-02-17,309,338,277708,2065647,4
2022-02-18,225,294,278002,2065647,4
2022-02-19,172,284,278286,2065647,4
2022-02-20,130,268,278554,2065647,4
2022-02-21,268,252,278806,2065647,4
2022-02-22,236,237,279043,2065647,4
2022-02-23,205,221,279264,2065647,4
2022-02-24,231,210,279474,2065647,4
2022-02-25,179,203,279677,2065647,4
2022-02-26,127,197,279874,2065647,4
2022-02-27,103,193,280067,2065647,4
2022-02-28,247,190,280257,2065647,4
2022-03-01,206,185,280442,2065647,4
2022-03-02,152,178,280620,2065647,4
2022-03-03,262,182,280802,2065647,4
2022-03-04,134,176,280978,2065647,4
2022-03-05,118,175,281153,2065647,4
2022-03-06,128,178,281331,2065647,4
2022-03-07,180,169,281500,2065647,4
2022-03-08,201,168,281668,2065647,4
2022-03-09,183,172,281840,2065647,4
2022-03-10,157,157,281997,2065647,4
2022-03-11,175,163,282160,2065647,4
2022-03-12,104,161,282321,2065647,4
2022-03-13,66,152,282473,2065647,4
2022-03-14,170,151,282624,2065647,4
2022-03-15,194,150,282774,2065647,NA
2022-03-16,247,159,282933,2065647,5
2022-03-17,218,168,283101,2065647,5
2022-03-18,177,168,283269,2065647,5
2022-03-19,149,174,283443,2065647,5
2022-03-20,150,186,283629,2065647,5
2022-03-21,273,201,283830,2065647,5
2022-03-22,398,230,284060,2065647,5
2022-03-23,415,254,284314,2065647,5
2022-03-24,439,286,284600,2065647,5
2022-03-25,414,320,284920,2065647,5
2022-03-26,308,342,285262,2065647,5
2022-03-27,304,364,285626,2065647,5
2022-03-28,550,404,286030,2065647,5
2022-03-29,580,430,286460,2065647,5
2022-03-30,665,466,286926,2065647,5
2022-03-31,557,483,287409,2065647,5
2022-04-01,649,516,287925,2065647,5
2022-04-02,462,538,288463,2065647,5
2022-04-03,473,562,289025,2065647,5
2022-04-04,672,580,289605,2065647,5
2022-04-05,787,609,290214,2065647,5
2022-04-06,741,620,290834,2065647,5
2022-04-07,704,641,291475,2065647,5
2022-04-08,611,636,292111,2065647,5
2022-04-09,479,638,292749,2065647,5
2022-04-10,462,637,293386,2065647,5
2022-04-11,616,629,294015,2065647,5
2022-04-12,624,605,294620,2065647,5
2022-04-13,798,613,295233,2065647,5
2022-04-14,586,597,295830,2065647,5
2022-04-15,425,570,296400,2065647,5
2022-04-16,327,548,296948,2065647,5
2022-04-17,270,521,297469,2065647,5
2022-04-18,371,486,297955,2065647,5
2022-04-19,466,463,298418,2065647,5
2022-04-20,581,432,298850,2065647,5
2022-04-21,392,405,299255,2065647,5
2022-04-22,452,408,299663,2065647,5
2022-04-23,334,409,300072,2065647,5
2022-04-24,318,416,300488,2065647,5
2022-04-25,379,417,300905,2065647,5
2022-04-26,391,407,301312,2065647,5
2022-04-27,390,379,301691,2065647,5
2022-04-28,371,376,302067,2065647,5
2022-04-29,348,362,302429,2065647,5
2022-04-30,185,340,302769,2065647,5
2022-05-01,201,324,303093,2065647,5
2022-05-02,304,313,303406,2065647,5
2022-05-03,333,305,303711,2065647,5
2022-05-04,247,284,303995,2065647,5
2022-05-05,257,268,304263,2065647,5
2022-05-06,212,248,304511,2065647,5
2022-05-07,131,241,304752,2065647,5
2022-05-08,169,236,304988,2065647,5
2022-05-09,188,220,305208,2065647,5
2022-05-10,209,202,305410,2065647,5
2022-05-11,264,204,305614,2065647,5
2022-05-12,171,192,305806,2065647,5
2022-05-13,172,186,305992,2065647,NA
2022-05-14,161,191,306183,2065647,NA
2022-05-15,130,185,306368,2065647,NA
2022-05-16,179,184,306552,2065647,NA
2022-05-17,148,175,306727,2065647,NA
2022-05-18,120,154,306881,2065647,NA
2022-05-19,117,147,307028,2065647,NA
