date,dailyCases,smoothedCases,cumulativeCases,Population,peak
2020-02-29,1,1,1,8419000,1
2020-03-01,0,0,1,8419000,1
2020-03-02,0,0,1,8419000,1
2020-03-03,1,0,1,8419000,1
2020-03-04,5,1,2,8419000,1
2020-03-05,3,2,4,8419000,1
2020-03-06,8,3,7,8419000,1
2020-03-07,7,3,10,8419000,1
2020-03-08,21,6,16,8419000,1
2020-03-09,57,15,31,8419000,1
2020-03-10,69,24,55,8419000,1
2020-03-11,155,46,101,8419000,1
2020-03-12,355,96,197,8419000,1
2020-03-13,619,183,380,8419000,1
2020-03-14,642,274,654,8419000,1
2020-03-15,1034,419,1073,8419000,1
2020-03-16,2121,714,1787,8419000,1
2020-03-17,2452,1054,2841,8419000,1
2020-03-18,2971,1456,4297,8419000,1
2020-03-19,3706,1935,6232,8419000,1
2020-03-20,4007,2419,8651,8419000,1
2020-03-21,2639,2704,11355,8419000,1
2020-03-22,2580,2925,14280,8419000,1
2020-03-23,3570,3132,17412,8419000,1
2020-03-24,4496,3424,20836,8419000,1
2020-03-25,4874,3696,24532,8419000,1
2020-03-26,5044,3887,28419,8419000,1
2020-03-27,5119,4046,32465,8419000,1
2020-03-28,3479,4166,36631,8419000,1
2020-03-29,3560,4306,40937,8419000,1
2020-03-30,6129,4672,45609,8419000,1
2020-03-31,5458,4809,50418,8419000,1
2020-04-01,5449,4891,55309,8419000,1
2020-04-02,5746,4991,60300,8419000,1
2020-04-03,5670,5070,65370,8419000,1
2020-04-04,3866,5125,70495,8419000,1
2020-04-05,3780,5157,75652,8419000,1
2020-04-06,6353,5189,80841,8419000,1
2020-04-07,6044,5273,86114,8419000,1
2020-04-08,5575,5291,91405,8419000,1
2020-04-09,5070,5194,96599,8419000,1
2020-04-10,4510,5028,101627,8419000,1
2020-04-11,3732,5009,106636,8419000,1
2020-04-12,2887,4882,111518,8419000,1
2020-04-13,3311,4447,115965,8419000,1
2020-04-14,4144,4176,120141,8419000,1
2020-04-15,3876,3933,124074,8419000,1
2020-04-16,3530,3713,127787,8419000,1
2020-04-17,3586,3581,131368,8419000,1
2020-04-18,2172,3358,134726,8419000,1
2020-04-19,2343,3280,138006,8419000,1
2020-04-20,3792,3349,141355,8419000,1
2020-04-21,3062,3194,144549,8419000,1
2020-04-22,3446,3133,147682,8419000,1
2020-04-23,2841,3035,150717,8419000,1
2020-04-24,2535,2884,153601,8419000,1
2020-04-25,1595,2802,156403,8419000,1
2020-04-26,1003,2611,159014,8419000,1
2020-04-27,2290,2396,161410,8419000,1
2020-04-28,2726,2348,163758,8419000,1
2020-04-29,2340,2190,165948,8419000,1
2020-04-30,2022,2073,168021,8419000,1
2020-05-01,1887,1980,170001,8419000,1
2020-05-02,1058,1904,171905,8419000,1
2020-05-03,787,1873,173778,8419000,1
2020-05-04,1550,1767,175545,8419000,1
2020-05-05,1512,1594,177139,8419000,1
2020-05-06,1397,1459,178598,8419000,1
2020-05-07,1238,1347,179945,8419000,1
2020-05-08,1079,1232,181177,8419000,1
2020-05-09,657,1174,182351,8419000,1
2020-05-10,457,1127,183478,8419000,1
2020-05-11,1231,1082,184560,8419000,1
2020-05-12,1285,1049,185609,8419000,1
2020-05-13,1333,1040,186649,8419000,1
2020-05-14,1110,1022,187671,8419000,1
2020-05-15,873,992,188663,8419000,1
2020-05-16,485,968,189631,8419000,1
2020-05-17,360,954,190585,8419000,1
2020-05-18,895,906,191491,8419000,1
2020-05-19,1003,866,192357,8419000,1
2020-05-20,1077,829,193186,8419000,1
2020-05-21,1069,823,194009,8419000,1
2020-05-22,1036,846,194855,8419000,1
2020-05-23,455,842,195697,8419000,1
2020-05-24,467,857,196554,8419000,1
2020-05-25,464,796,197350,8419000,1
2020-05-26,1050,803,198153,8419000,1
2020-05-27,741,755,198908,8419000,1
2020-05-28,646,694,199602,8419000,1
2020-05-29,639,637,200239,8419000,1
2020-05-30,346,622,200861,8419000,1
2020-05-31,230,588,201449,8419000,1
2020-06-01,686,620,202069,8419000,1
2020-06-02,570,551,202620,8419000,1
2020-06-03,515,519,203139,8419000,1
2020-06-04,517,500,203639,8419000,1
2020-06-05,402,467,204106,8419000,1
2020-06-06,247,452,204558,8419000,1
2020-06-07,197,448,205006,8419000,1
2020-06-08,447,414,205420,8419000,1
2020-06-09,419,392,205812,8419000,1
2020-06-10,363,370,206182,8419000,1
2020-06-11,363,348,206530,8419000,1
2020-06-12,409,349,206879,8419000,1
2020-06-13,196,342,207221,8419000,1
2020-06-14,180,340,207561,8419000,1
2020-06-15,380,330,207891,8419000,NA
2020-06-16,419,330,208221,8419000,NA
2020-06-17,356,329,208550,8419000,NA
2020-06-18,378,331,208881,8419000,NA
2020-06-19,361,324,209205,8419000,NA
2020-06-20,203,325,209530,8419000,NA
2020-06-21,172,324,209854,8419000,NA
2020-06-22,402,327,210181,8419000,NA
2020-06-23,381,322,210503,8419000,NA
2020-06-24,381,325,210828,8419000,NA
2020-06-25,298,314,211142,8419000,NA
2020-06-26,317,308,211450,8419000,NA
2020-06-27,206,308,211758,8419000,NA
2020-06-28,201,312,212070,8419000,NA
2020-06-29,437,317,212387,8419000,NA
2020-06-30,441,326,212713,8419000,NA
2020-07-01,395,328,213041,8419000,NA
2020-07-02,416,345,213386,8419000,NA
2020-07-03,234,333,213719,8419000,NA
2020-07-04,120,321,214040,8419000,NA
2020-07-05,155,314,214354,8419000,NA
2020-07-06,431,313,214667,8419000,NA
2020-07-07,461,316,214983,8419000,NA
2020-07-08,437,322,215305,8419000,NA
2020-07-09,391,318,215623,8419000,NA
2020-07-10,306,329,215952,8419000,NA
2020-07-11,259,349,216301,8419000,NA
2020-07-12,223,358,216659,8419000,NA
2020-07-13,483,366,217025,8419000,NA
2020-07-14,402,357,217382,8419000,NA
2020-07-15,440,358,217740,8419000,NA
2020-07-16,411,361,218101,8419000,NA
2020-07-17,413,376,218477,8419000,NA
2020-07-18,216,370,218847,8419000,NA
2020-07-19,176,363,219210,8419000,NA
2020-07-20,401,351,219561,8419000,NA
2020-07-21,340,342,219903,8419000,NA
2020-07-22,329,327,220230,8419000,NA
2020-07-23,308,312,220542,8419000,NA
2020-07-24,298,295,220837,8419000,NA
2020-07-25,153,286,221123,8419000,NA
2020-07-26,140,281,221404,8419000,NA
2020-07-27,312,269,221673,8419000,NA
2020-07-28,313,265,221938,8419000,NA
2020-07-29,287,259,222197,8419000,NA
2020-07-30,274,254,222451,8419000,NA
2020-07-31,262,249,222700,8419000,NA
2020-08-01,189,254,222954,8419000,NA
2020-08-02,135,253,223207,8419000,NA
2020-08-03,348,258,223465,8419000,NA
2020-08-04,187,240,223705,8419000,NA
2020-08-05,298,242,223947,8419000,NA
2020-08-06,288,244,224191,8419000,NA
2020-08-07,255,243,224434,8419000,NA
2020-08-08,160,239,224673,8419000,NA
2020-08-09,133,238,224911,8419000,NA
2020-08-10,312,233,225144,8419000,NA
2020-08-11,263,244,225388,8419000,NA
2020-08-12,320,247,225635,8419000,NA
2020-08-13,276,246,225881,8419000,NA
2020-08-14,277,249,226130,8419000,NA
2020-08-15,151,247,226377,8419000,NA
2020-08-16,140,248,226625,8419000,NA
2020-08-17,333,251,226876,8419000,NA
2020-08-18,283,254,227130,8419000,NA
2020-08-19,257,245,227375,8419000,NA
2020-08-20,227,238,227613,8419000,NA
2020-08-21,252,235,227848,8419000,NA
2020-08-22,136,233,228081,8419000,NA
2020-08-23,150,234,228315,8419000,NA
2020-08-24,297,229,228544,8419000,NA
2020-08-25,283,229,228773,8419000,NA
2020-08-26,313,237,229010,8419000,NA
2020-08-27,274,244,229254,8419000,NA
2020-08-28,280,248,229502,8419000,NA
2020-08-29,128,246,229748,8419000,NA
2020-08-30,186,252,230000,8419000,NA
2020-08-31,315,254,230254,8419000,NA
2020-09-01,294,256,230510,8419000,NA
2020-09-02,271,250,230760,8419000,NA
2020-09-03,273,250,231010,8419000,NA
2020-09-04,230,242,231252,8419000,NA
2020-09-05,156,246,231498,8419000,NA
2020-09-06,207,249,231747,8419000,NA
2020-09-07,217,235,231982,8419000,NA
2020-09-08,393,250,232232,8419000,NA
2020-09-09,353,261,232493,8419000,NA
2020-09-10,323,268,232761,8419000,NA
2020-09-11,313,280,233041,8419000,NA
2020-09-12,202,287,233328,8419000,NA
2020-09-13,263,295,233623,8419000,NA
2020-09-14,461,330,233953,8419000,NA
2020-09-15,414,333,234286,8419000,NA
2020-09-16,456,347,234633,8419000,NA
2020-09-17,441,364,234997,8419000,NA
2020-09-18,292,361,235358,8419000,NA
2020-09-19,216,363,235721,8419000,NA
2020-09-20,220,357,236078,8419000,NA
2020-09-21,558,371,236449,8419000,NA
2020-09-22,497,383,236832,8419000,NA
2020-09-23,612,405,237237,8419000,NA
2020-09-24,542,420,237657,8419000,NA
2020-09-25,463,444,238101,8419000,NA
2020-09-26,280,453,238554,8419000,NA
2020-09-27,382,476,239030,8419000,NA
2020-09-28,437,459,239489,8419000,NA
2020-09-29,723,491,239980,8419000,NA
2020-09-30,605,490,240470,8419000,NA
2020-10-01,705,514,240984,8419000,2
2020-10-02,605,534,241518,8419000,2
2020-10-03,299,537,242055,8419000,2
2020-10-04,335,530,242585,8419000,2
2020-10-05,766,577,243162,8419000,2
2020-10-06,571,555,243717,8419000,2
2020-10-07,542,546,244263,8419000,2
2020-10-08,525,520,244783,8419000,2
2020-10-09,524,509,245292,8419000,2
2020-10-10,314,511,245803,8419000,2
2020-10-11,281,503,246306,8419000,2
2020-10-12,515,467,246773,8419000,2
2020-10-13,588,470,247243,8419000,2
2020-10-14,583,476,247719,8419000,2
2020-10-15,604,487,248206,8419000,2
2020-10-16,503,484,248690,8419000,2
2020-10-17,366,491,249181,8419000,2
2020-10-18,412,510,249691,8419000,2
2020-10-19,626,526,250217,8419000,2
2020-10-20,601,528,250745,8419000,2
2020-10-21,654,538,251283,8419000,2
2020-10-22,759,560,251843,8419000,2
2020-10-23,601,574,252417,8419000,2
2020-10-24,386,577,252994,8419000,2
2020-10-25,362,570,253564,8419000,2
2020-10-26,695,580,254144,8419000,2
2020-10-27,742,600,254744,8419000,2
2020-10-28,783,618,255362,8419000,2
2020-10-29,621,599,255961,8419000,2
2020-10-30,654,606,256567,8419000,2
2020-10-31,403,609,257176,8419000,2
2020-11-01,501,628,257804,8419000,2
2020-11-02,953,665,258469,8419000,2
2020-11-03,903,688,259157,8419000,2
2020-11-04,1113,735,259892,8419000,2
2020-11-05,1139,809,260701,8419000,2
2020-11-06,1037,864,261565,8419000,2
2020-11-07,845,927,262492,8419000,2
2020-11-08,788,968,263460,8419000,2
2020-11-09,1545,1053,264513,8419000,2
2020-11-10,1599,1152,265665,8419000,2
2020-11-11,1540,1213,266878,8419000,2
2020-11-12,1501,1265,268143,8419000,2
2020-11-13,1494,1330,269473,8419000,2
2020-11-14,1026,1356,270829,8419000,2
2020-11-15,896,1372,272201,8419000,2
2020-11-16,1832,1413,273614,8419000,2
2020-11-17,1730,1431,275045,8419000,2
2020-11-18,1753,1462,276507,8419000,2
2020-11-19,1857,1513,278020,8419000,2
2020-11-20,1773,1552,279572,8419000,2
2020-11-21,1290,1590,281162,8419000,2
2020-11-22,1148,1626,282788,8419000,2
2020-11-23,2317,1695,284483,8419000,2
2020-11-24,2073,1744,286227,8419000,2
2020-11-25,2370,1833,288060,8419000,2
2020-11-26,817,1684,289744,8419000,2
2020-11-27,2298,1759,291503,8419000,2
2020-11-28,1839,1837,293340,8419000,2
2020-11-29,1891,1944,295284,8419000,2
2020-11-30,2895,2026,297310,8419000,2
2020-12-01,3308,2203,299513,8419000,2
2020-12-02,3129,2311,301824,8419000,2
2020-12-03,2945,2615,304439,8419000,2
2020-12-04,2816,2689,307128,8419000,2
2020-12-05,1887,2696,309824,8419000,2
2020-12-06,1755,2676,312500,8419000,2
2020-12-07,3304,2735,315235,8419000,2
2020-12-08,3059,2699,317934,8419000,2
2020-12-09,3106,2696,320630,8419000,2
2020-12-10,3149,2725,323355,8419000,2
2020-12-11,2980,2749,326104,8419000,2
2020-12-12,2206,2794,328898,8419000,2
2020-12-13,2176,2854,331752,8419000,2
2020-12-14,3578,2893,334645,8419000,2
2020-12-15,3681,2982,337627,8419000,2
2020-12-16,2787,2937,340564,8419000,2
2020-12-17,1926,2762,343326,8419000,2
2020-12-18,3427,2826,346152,8419000,2
2020-12-19,2557,2876,349028,8419000,2
2020-12-20,2346,2900,351928,8419000,2
2020-12-21,4338,3009,354937,8419000,2
2020-12-22,4100,3069,358006,8419000,2
2020-12-23,3844,3220,361226,8419000,2
2020-12-24,3015,3375,364601,8419000,2
2020-12-25,1046,3035,367636,8419000,2
2020-12-26,3455,3163,370799,8419000,2
2020-12-27,2889,3241,374040,8419000,2
2020-12-28,5392,3392,377432,8419000,2
2020-12-29,5206,3550,380982,8419000,2
2020-12-30,4985,3713,384695,8419000,2
2020-12-31,3393,3767,388462,8419000,2
2021-01-01,1340,3809,392271,8419000,2
2021-01-02,4202,3915,396186,8419000,2
2021-01-03,3465,3998,400184,8419000,2
2021-01-04,6604,4171,404355,8419000,2
2021-01-05,6156,4306,408661,8419000,2
2021-01-06,5684,4406,413067,8419000,2
2021-01-07,5445,4699,417766,8419000,2
2021-01-08,5298,5265,423031,8419000,2
2021-01-09,3690,5192,428223,8419000,2
2021-01-10,3199,5154,433377,8419000,2
2021-01-11,5914,5055,438432,8419000,2
2021-01-12,5235,4924,443356,8419000,2
2021-01-13,5176,4851,448207,8419000,2
2021-01-14,5257,4824,453031,8419000,2
2021-01-15,4843,4759,457790,8419000,2
2021-01-16,3478,4729,462519,8419000,2
2021-01-17,2919,4689,467208,8419000,2
2021-01-18,4642,4507,471715,8419000,2
2021-01-19,5140,4494,476209,8419000,2
2021-01-20,4908,4455,480664,8419000,2
2021-01-21,4938,4410,485074,8419000,2
2021-01-22,4715,4391,489465,8419000,2
2021-01-23,3461,4389,493854,8419000,2
2021-01-24,2930,4391,498245,8419000,2
2021-01-25,5817,4558,502803,8419000,2
2021-01-26,4866,4519,507322,8419000,2
2021-01-27,5005,4533,511855,8419000,2
2021-01-28,4794,4513,516368,8419000,2
2021-01-29,3671,4363,520731,8419000,2
2021-01-30,2877,4280,525011,8419000,2
2021-01-31,2894,4275,529286,8419000,2
2021-02-01,980,3584,532870,8419000,2
2021-02-02,2659,3269,536139,8419000,2
2021-02-03,5145,3289,539428,8419000,2
2021-02-04,4853,3297,542725,8419000,2
2021-02-05,4158,3367,546092,8419000,2
2021-02-06,3080,3396,549488,8419000,2
2021-02-07,1645,3217,552705,8419000,2
2021-02-08,4432,3710,556415,8419000,2
2021-02-09,3736,3864,560279,8419000,2
2021-02-10,3778,3669,563948,8419000,2
2021-02-11,3415,3463,567411,8419000,2
2021-02-12,3314,3343,570754,8419000,2
2021-02-13,2206,3218,573972,8419000,2
2021-02-14,1894,3254,577226,8419000,2
2021-02-15,2862,3029,580255,8419000,2
2021-02-16,3723,3027,583282,8419000,2
2021-02-17,3436,2979,586261,8419000,2
2021-02-18,2048,2783,589044,8419000,2
2021-02-19,3019,2741,591785,8419000,2
2021-02-20,2494,2782,594567,8419000,2
2021-02-21,2285,2838,597405,8419000,2
2021-02-22,3627,2947,600352,8419000,2
2021-02-23,3473,2912,603264,8419000,2
2021-02-24,3464,2916,606180,8419000,2
2021-02-25,3482,3121,609301,8419000,2
2021-02-26,3242,3152,612453,8419000,2
2021-02-27,2017,3084,615537,8419000,2
2021-02-28,2038,3049,618586,8419000,2
2021-03-01,3727,3063,621649,8419000,2
2021-03-02,3109,3011,624660,8419000,2
2021-03-03,3244,2980,627640,8419000,2
2021-03-04,3120,2928,630568,8419000,2
2021-03-05,2888,2878,633446,8419000,2
2021-03-06,2043,2881,636327,8419000,2
2021-03-07,1875,2858,639185,8419000,2
2021-03-08,3402,2812,641997,8419000,2
2021-03-09,3342,2845,644842,8419000,2
2021-03-10,3203,2839,647681,8419000,2
2021-03-11,3107,2837,650518,8419000,2
2021-03-12,3204,2882,653400,8419000,2
2021-03-13,2174,2901,656301,8419000,2
2021-03-14,1926,2908,659209,8419000,2
2021-03-15,3395,2907,662116,8419000,2
2021-03-16,3195,2886,665002,8419000,2
2021-03-17,3174,2882,667884,8419000,2
2021-03-18,2921,2856,670740,8419000,2
2021-03-19,3048,2833,673573,8419000,2
2021-03-20,2160,2831,676404,8419000,2
2021-03-21,2093,2855,679259,8419000,2
2021-03-22,3882,2925,682184,8419000,2
2021-03-23,3254,2933,685117,8419000,2
2021-03-24,3452,2973,688090,8419000,2
2021-03-25,3797,3098,691188,8419000,2
2021-03-26,3416,3151,694339,8419000,2
2021-03-27,2221,3159,697498,8419000,2
2021-03-28,1751,3110,700608,8419000,2
2021-03-29,3558,3064,703672,8419000,2
2021-03-30,3185,3054,706726,8419000,2
2021-03-31,3185,3016,709742,8419000,2
2021-04-01,2866,2883,712625,8419000,2
2021-04-02,2620,2769,715394,8419000,2
2021-04-03,2050,2745,718139,8419000,2
2021-04-04,1466,2704,720843,8419000,2
2021-04-05,3270,2663,723506,8419000,2
2021-04-06,3003,2637,726143,8419000,2
2021-04-07,2763,2577,728720,8419000,2
2021-04-08,2575,2535,731255,8419000,2
2021-04-09,2467,2513,733768,8419000,2
2021-04-10,1723,2467,736235,8419000,2
2021-04-11,1315,2445,738680,8419000,2
2021-04-12,2534,2340,741020,8419000,2
2021-04-13,2363,2249,743269,8419000,2
2021-04-14,2242,2174,745443,8419000,2
2021-04-15,2015,2094,747537,8419000,2
2021-04-16,1832,2003,749540,8419000,2
2021-04-17,1275,1939,751479,8419000,2
2021-04-18,1050,1902,753381,8419000,2
2021-04-19,1884,1809,755190,8419000,2
2021-04-20,1606,1701,756891,8419000,2
2021-04-21,1423,1584,758475,8419000,2
2021-04-22,1360,1490,759965,8419000,2
2021-04-23,1288,1412,761377,8419000,2
2021-04-24,854,1352,762729,8419000,2
2021-04-25,754,1310,764039,8419000,2
2021-04-26,1372,1237,765276,8419000,2
2021-04-27,1136,1170,766446,8419000,2
2021-04-28,1214,1140,767586,8419000,2
2021-04-29,1053,1096,768682,8419000,2
2021-04-30,952,1048,769730,8419000,2
2021-05-01,578,1008,770738,8419000,2
2021-05-02,568,982,771720,8419000,2
2021-05-03,935,919,772639,8419000,2
2021-05-04,876,882,773521,8419000,2
2021-05-05,778,820,774341,8419000,2
2021-05-06,785,782,775123,8419000,2
2021-05-07,715,748,775871,8419000,2
2021-05-08,384,720,776591,8419000,2
2021-05-09,343,688,777279,8419000,2
2021-05-10,654,648,777927,8419000,2
2021-05-11,628,612,778539,8419000,2
2021-05-12,594,586,779125,8419000,2
2021-05-13,516,548,779673,8419000,2
2021-05-14,487,515,780188,8419000,2
2021-05-15,292,502,780690,8419000,2
2021-05-16,280,493,781183,8419000,2
2021-05-17,453,464,781647,8419000,2
2021-05-18,415,434,782081,8419000,2
2021-05-19,377,403,782484,8419000,2
2021-05-20,395,386,782870,8419000,2
2021-05-21,349,366,783236,8419000,2
2021-05-22,233,357,783593,8419000,2
2021-05-23,187,344,783937,8419000,2
2021-05-24,355,330,784267,8419000,2
2021-05-25,306,315,784582,8419000,2
2021-05-26,249,296,784878,8419000,2
2021-05-27,257,277,785155,8419000,2
2021-05-28,210,257,785412,8419000,2
2021-05-29,126,241,785653,8419000,2
2021-05-30,118,232,785885,8419000,2
2021-05-31,117,198,786083,8419000,2
2021-06-01,289,195,786278,8419000,NA
2021-06-02,244,194,786472,8419000,NA
2021-06-03,206,187,786659,8419000,NA
2021-06-04,225,189,786848,8419000,NA
2021-06-05,142,192,787040,8419000,NA
2021-06-06,130,193,787233,8419000,NA
2021-06-07,221,208,787441,8419000,NA
2021-06-08,176,192,787633,8419000,NA
2021-06-09,211,187,787820,8419000,NA
2021-06-10,156,180,788000,8419000,NA
2021-06-11,189,175,788175,8419000,NA
2021-06-12,121,172,788347,8419000,NA
2021-06-13,115,170,788517,8419000,NA
2021-06-14,181,164,788681,8419000,NA
2021-06-15,180,165,788846,8419000,NA
2021-06-16,173,159,789005,8419000,NA
2021-06-17,189,164,789169,8419000,NA
2021-06-18,160,160,789329,8419000,NA
2021-06-19,107,158,789487,8419000,NA
2021-06-20,96,155,789642,8419000,NA
2021-06-21,168,153,789795,8419000,NA
2021-06-22,171,152,789947,8419000,NA
2021-06-23,187,154,790101,8419000,NA
2021-06-24,175,152,790253,8419000,NA
2021-06-25,180,155,790408,8419000,NA
2021-06-26,118,156,790564,8419000,NA
2021-06-27,110,158,790722,8419000,NA
2021-06-28,206,164,790886,8419000,NA
2021-06-29,212,170,791056,8419000,NA
2021-06-30,226,175,791231,8419000,NA
2021-07-01,204,179,791410,8419000,3
2021-07-02,232,187,791597,8419000,3
2021-07-03,146,191,791788,8419000,3
2021-07-04,124,193,791981,8419000,3
2021-07-05,188,190,792171,8419000,3
2021-07-06,364,212,792383,8419000,3
2021-07-07,403,237,792620,8419000,3
2021-07-08,369,261,792881,8419000,3
2021-07-09,370,281,793162,8419000,3
2021-07-10,238,294,793456,8419000,3
2021-07-11,274,315,793771,8419000,3
2021-07-12,477,356,794127,8419000,3
2021-07-13,459,370,794497,8419000,3
2021-07-14,550,391,794888,8419000,3
2021-07-15,552,417,795305,8419000,3
2021-07-16,557,444,795749,8419000,3
2021-07-17,340,458,796207,8419000,3
2021-07-18,394,476,796683,8419000,3
2021-07-19,813,524,797207,8419000,3
2021-07-20,712,560,797767,8419000,3
2021-07-21,895,609,798376,8419000,3
2021-07-22,976,670,799046,8419000,3
2021-07-23,919,721,799767,8419000,3
2021-07-24,552,752,800519,8419000,3
2021-07-25,635,786,801305,8419000,3
2021-07-26,1228,845,802150,8419000,3
2021-07-27,1201,915,803065,8419000,3
2021-07-28,1244,965,804030,8419000,3
2021-07-29,1290,1010,805040,8419000,3
2021-07-30,1282,1062,806102,8419000,3
2021-07-31,850,1104,807206,8419000,3
2021-08-01,831,1132,808338,8419000,3
2021-08-02,1569,1181,809519,8419000,3
2021-08-03,1584,1236,810755,8419000,3
2021-08-04,1614,1289,812044,8419000,3
2021-08-05,1529,1323,813367,8419000,3
2021-08-06,1577,1365,814732,8419000,3
2021-08-07,1149,1408,816140,8419000,3
2021-08-08,1071,1442,817582,8419000,3
2021-08-09,1890,1488,819070,8419000,3
2021-08-10,1666,1499,820569,8419000,3
2021-08-11,1753,1519,822088,8419000,3
2021-08-12,1758,1552,823640,8419000,3
2021-08-13,1601,1555,825195,8419000,3
2021-08-14,1048,1541,826736,8419000,3
2021-08-15,1146,1552,828288,8419000,3
2021-08-16,1928,1557,829845,8419000,3
2021-08-17,1746,1569,831414,8419000,3
2021-08-18,1815,1577,832991,8419000,3
2021-08-19,1694,1568,834559,8419000,3
2021-08-20,1561,1563,836122,8419000,3
2021-08-21,1091,1569,837691,8419000,3
2021-08-22,718,1508,839199,8419000,3
2021-08-23,1954,1511,840710,8419000,3
2021-08-24,1839,1525,842235,8419000,3
2021-08-25,1786,1520,843755,8419000,3
2021-08-26,1645,1513,845268,8419000,3
2021-08-27,1451,1498,846766,8419000,3
2021-08-28,985,1483,848249,8419000,3
2021-08-29,989,1521,849770,8419000,3
2021-08-30,1840,1505,851275,8419000,3
2021-08-31,1624,1474,852749,8419000,3
2021-09-01,1558,1442,854191,8419000,3
2021-09-02,1431,1411,855602,8419000,3
2021-09-03,1422,1407,857009,8419000,3
2021-09-04,905,1396,858405,8419000,3
2021-09-05,952,1390,859795,8419000,3
2021-09-06,943,1262,861057,8419000,3
2021-09-07,1569,1254,862311,8419000,3
2021-09-08,1590,1259,863570,8419000,3
2021-09-09,1714,1299,864869,8419000,3
2021-09-10,1547,1317,866186,8419000,3
2021-09-11,1036,1336,867522,8419000,3
2021-09-12,1213,1373,868895,8419000,3
2021-09-13,1738,1487,870382,8419000,3
2021-09-14,1641,1497,871879,8419000,3
2021-09-15,1608,1500,873379,8419000,3
2021-09-16,1387,1453,874832,8419000,3
2021-09-17,1525,1450,876282,8419000,3
2021-09-18,956,1438,877720,8419000,3
2021-09-19,1058,1416,879136,8419000,3
2021-09-20,1641,1402,880538,8419000,3
2021-09-21,1302,1354,881892,8419000,3
2021-09-22,1415,1326,883218,8419000,3
2021-09-23,1291,1313,884531,8419000,3
2021-09-24,1222,1269,885800,8419000,3
2021-09-25,814,1249,887049,8419000,3
2021-09-26,856,1220,888269,8419000,3
2021-09-27,1391,1184,889453,8419000,3
2021-09-28,1119,1158,890611,8419000,3
2021-09-29,1096,1113,891724,8419000,3
2021-09-30,1139,1091,892815,8419000,3
2021-10-01,1089,1072,893887,8419000,3
2021-10-02,680,1053,894940,8419000,3
2021-10-03,906,1060,896000,8419000,3
2021-10-04,1270,1043,897043,8419000,3
2021-10-05,1270,1064,898107,8419000,3
2021-10-06,1147,1072,899179,8419000,3
2021-10-07,1079,1063,900242,8419000,3
2021-10-08,1012,1052,901294,8419000,3
2021-10-09,612,1042,902336,8419000,3
2021-10-10,688,1011,903347,8419000,3
2021-10-11,933,963,904310,8419000,3
2021-10-12,1142,945,905255,8419000,3
2021-10-13,1111,940,906195,8419000,3
2021-10-14,1023,932,907127,8419000,3
2021-10-15,884,913,908040,8419000,3
2021-10-16,488,896,908936,8419000,3
2021-10-17,587,881,909817,8419000,3
2021-10-18,871,872,910689,8419000,3
2021-10-19,797,823,911512,8419000,3
2021-10-20,800,779,912291,8419000,3
2021-10-21,810,748,913039,8419000,3
2021-10-22,695,721,913760,8419000,3
2021-10-23,451,716,914476,8419000,3
2021-10-24,446,696,915172,8419000,3
2021-10-25,895,699,915871,8419000,3
2021-10-26,597,671,916542,8419000,3
2021-10-27,758,665,917207,8419000,3
2021-10-28,738,654,917861,8419000,3
2021-10-29,642,647,918508,8419000,3
2021-10-30,399,639,919147,8419000,3
2021-10-31,446,639,919786,8419000,3
2021-11-01,779,623,920409,8419000,4
2021-11-02,805,652,921061,8419000,4
2021-11-03,825,662,921723,8419000,4
2021-11-04,907,686,922409,8419000,4
2021-11-05,770,704,923113,8419000,4
2021-11-06,508,720,923833,8419000,4
2021-11-07,542,734,924567,8419000,4
2021-11-08,1135,785,925352,8419000,4
2021-11-09,1036,818,926170,8419000,4
2021-11-10,1047,849,927019,8419000,4
2021-11-11,874,845,927864,8419000,4
2021-11-12,1029,882,928746,8419000,4
2021-11-13,615,897,929643,8419000,4
2021-11-14,686,917,930560,8419000,4
2021-11-15,1262,936,931496,8419000,4
2021-11-16,1273,969,932465,8419000,4
2021-11-17,1329,1010,933475,8419000,4
2021-11-18,1310,1072,934547,8419000,4
2021-11-19,1184,1094,935641,8419000,4
2021-11-20,826,1124,936765,8419000,4
2021-11-21,840,1146,937911,8419000,4
2021-11-22,1529,1184,939095,8419000,4
2021-11-23,1377,1199,940294,8419000,4
2021-11-24,1417,1212,941506,8419000,4
2021-11-25,531,1101,942607,8419000,4
2021-11-26,1170,1099,943706,8419000,4
2021-11-27,971,1119,944825,8419000,4
2021-11-28,1059,1151,945976,8419000,4
2021-11-29,2332,1265,947241,8419000,4
2021-11-30,2006,1355,948596,8419000,4
2021-12-01,2181,1464,950060,8419000,4
2021-12-02,2106,1689,951749,8419000,4
2021-12-03,1896,1793,953542,8419000,4
2021-12-04,1322,1843,955385,8419000,4
2021-12-05,1403,1892,957277,8419000,4
2021-12-06,2797,1959,959236,8419000,4
2021-12-07,2918,2089,961325,8419000,4
2021-12-08,3137,2226,963551,8419000,4
2021-12-09,3023,2357,965908,8419000,4
2021-12-10,3087,2527,968435,8419000,4
2021-12-11,2160,2646,971081,8419000,4
2021-12-12,2794,2845,973926,8419000,4
2021-12-13,7525,3521,977447,8419000,4
2021-12-14,10864,4656,982103,8419000,4
2021-12-15,13159,6087,988190,8419000,4
2021-12-16,13842,7633,995823,8419000,4
2021-12-17,13541,9126,1004949,8419000,4
2021-12-18,9942,10238,1015187,8419000,4
2021-12-19,10549,11346,1026533,8419000,4
2021-12-20,27932,14261,1040794,8419000,4
2021-12-21,30352,17045,1057839,8419000,4
2021-12-22,31334,19642,1077481,8419000,4
2021-12-23,31772,22203,1099684,8419000,4
2021-12-24,17444,22761,1122445,8419000,4
2021-12-25,7781,22452,1144897,8419000,4
2021-12-26,22927,24220,1169117,8419000,4
2021-12-27,51149,27537,1196654,8419000,4
2021-12-28,49389,30257,1226911,8419000,4
2021-12-29,50356,32974,1259885,8419000,4
2021-12-30,47083,35161,1295046,8419000,4
2021-12-31,29016,36814,1331860,8419000,4
2022-01-01,11994,37416,1369276,8419000,4
2022-01-02,32441,38775,1408051,8419000,4
2022-01-03,54830,39301,1447352,8419000,4
2022-01-04,49012,39247,1486599,8419000,4
2022-01-05,40072,37778,1524377,8419000,4
2022-01-06,36197,36223,1560600,8419000,4
2022-01-07,23072,35374,1595974,8419000,4
2022-01-08,16121,35964,1631938,8419000,4
2022-01-09,14307,33373,1665311,8419000,4
2022-01-10,24293,29011,1694322,8419000,4
2022-01-11,18080,24592,1718914,8419000,4
2022-01-12,18386,21494,1740408,8419000,4
2022-01-13,15937,18599,1759007,8419000,4
2022-01-14,13308,17205,1776212,8419000,4
2022-01-15,6756,15867,1792079,8419000,4
2022-01-16,6873,14805,1806884,8419000,4
2022-01-17,9602,12706,1819590,8419000,4
2022-01-18,10921,11683,1831273,8419000,4
2022-01-19,9003,10343,1841616,8419000,4
2022-01-20,7023,9069,1850685,8419000,4
2022-01-21,5790,7995,1858680,8419000,4
2022-01-22,3638,7550,1866230,8419000,4
2022-01-23,3395,7053,1873283,8419000,4
2022-01-24,5810,6511,1879794,8419000,4
2022-01-25,4754,5630,1885424,8419000,4
2022-01-26,4193,4943,1890367,8419000,4
2022-01-27,3638,4460,1894827,8419000,4
2022-01-28,2722,4021,1898848,8419000,4
2022-01-29,512,3575,1902423,8419000,4
2022-01-30,1426,3294,1905717,8419000,4
2022-01-31,3113,2908,1908625,8419000,4
2022-02-01,2242,2549,1911174,8419000,4
2022-02-02,2319,2282,1913456,8419000,4
2022-02-03,2003,2048,1915504,8419000,4
2022-02-04,1537,1879,1917383,8419000,4
2022-02-05,943,1940,1919323,8419000,4
2022-02-06,865,1860,1921183,8419000,4
2022-02-07,1602,1644,1922827,8419000,4
2022-02-08,1513,1540,1924367,8419000,4
2022-02-09,1313,1397,1925764,8419000,4
2022-02-10,1219,1285,1927049,8419000,4
2022-02-11,983,1205,1928254,8419000,4
2022-02-12,635,1161,1929415,8419000,4
2022-02-13,458,1103,1930518,8419000,4
2022-02-14,1014,1019,1931537,8419000,4
2022-02-15,941,938,1932475,8419000,4
2022-02-16,935,884,1933359,8419000,4
2022-02-17,828,828,1934187,8419000,4
2022-02-18,663,782,1934969,8419000,4
2022-02-19,425,752,1935721,8419000,4
2022-02-20,380,741,1936462,8419000,4
2022-02-21,558,676,1937138,8419000,4
2022-02-22,684,639,1937777,8419000,4
2022-02-23,703,606,1938383,8419000,4
2022-02-24,657,581,1938964,8419000,4
2022-02-25,533,563,1939527,8419000,4
2022-02-26,337,550,1940077,8419000,4
2022-02-27,360,547,1940624,8419000,4
2022-02-28,703,568,1941192,8419000,4
2022-03-01,609,557,1941749,8419000,4
2022-03-02,638,548,1942297,8419000,4
2022-03-03,584,538,1942835,8419000,4
2022-03-04,456,527,1943362,8419000,4
2022-03-05,316,524,1943886,8419000,4
2022-03-06,337,520,1944406,8419000,4
2022-03-07,651,513,1944919,8419000,4
2022-03-08,677,523,1945442,8419000,4
2022-03-09,624,521,1945963,8419000,4
2022-03-10,697,537,1946500,8419000,4
2022-03-11,601,558,1947058,8419000,4
2022-03-12,296,555,1947613,8419000,4
2022-03-13,436,569,1948182,8419000,4
2022-03-14,888,603,1948785,8419000,4
2022-03-15,831,625,1949410,8419000,NA
2022-03-16,863,659,1950069,8419000,NA
2022-03-17,748,666,1950735,8419000,NA
2022-03-18,797,694,1951429,8419000,NA
2022-03-19,447,716,1952145,8419000,NA
2022-03-20,636,744,1952889,8419000,NA
2022-03-21,1291,802,1953691,8419000,NA
2022-03-22,1246,861,1954552,8419000,NA
2022-03-23,1263,918,1955470,8419000,NA
2022-03-24,1168,978,1956448,8419000,NA
2022-03-25,1087,1020,1957468,8419000,NA
2022-03-26,664,1051,1958519,8419000,NA
2022-03-27,775,1071,1959590,8419000,NA
2022-03-28,1496,1100,1960690,8419000,NA
2022-03-29,1422,1125,1961815,8419000,NA
2022-03-30,1499,1159,1962974,8419000,NA
2022-03-31,1487,1204,1964178,8419000,NA
2022-04-01,1313,1237,1965415,8419000,NA
2022-04-02,856,1264,1966679,8419000,NA
2022-04-03,874,1278,1967957,8419000,NA
2022-04-04,2107,1365,1969322,8419000,NA
2022-04-05,1860,1428,1970750,8419000,NA
2022-04-06,1950,1492,1972242,8419000,NA
2022-04-07,1774,1533,1973775,8419000,NA
2022-04-08,1495,1559,1975334,8419000,NA
