date,dailyCases,smoothedCases,cumulativeCases,Population,peak
2020-02-29,1,1,1,8419000,1
2020-03-01,0,0,1,8419000,1
2020-03-02,0,0,1,8419000,1
2020-03-03,1,0,1,8419000,1
2020-03-04,5,2,3,8419000,1
2020-03-05,3,3,6,8419000,1
2020-03-06,8,5,11,8419000,1
2020-03-07,7,6,17,8419000,1
2020-03-08,21,12,29,8419000,1
2020-03-09,57,28,57,8419000,1
2020-03-10,69,49,106,8419000,1
2020-03-11,155,94,200,8419000,1
2020-03-12,355,193,393,8419000,1
2020-03-13,619,376,769,8419000,1
2020-03-14,642,539,1308,8419000,1
2020-03-15,1034,765,2073,8419000,1
2020-03-16,2121,1266,3339,8419000,1
2020-03-17,2452,1869,5208,8419000,1
2020-03-18,2971,2515,7723,8419000,1
2020-03-19,3706,3043,10766,8419000,1
2020-03-20,4007,3561,14327,8419000,1
2020-03-21,2639,3451,17778,8419000,1
2020-03-22,2580,3075,20853,8419000,1
2020-03-23,3570,2930,23783,8419000,1
2020-03-24,4496,3549,27332,8419000,1
2020-03-25,4874,4313,31645,8419000,1
2020-03-26,5044,4805,36450,8419000,1
2020-03-27,5119,5012,41462,8419000,1
2020-03-28,3479,4547,46009,8419000,1
2020-03-29,3560,4053,50062,8419000,1
2020-03-30,6129,4389,54451,8419000,1
2020-03-31,5458,5049,59500,8419000,1
2020-04-01,5449,5679,65179,8419000,1
2020-04-02,5746,5551,70730,8419000,1
2020-04-03,5670,5622,76352,8419000,1
2020-04-04,3866,5094,81446,8419000,1
2020-04-05,3780,4439,85885,8419000,1
2020-04-06,6353,4666,90551,8419000,1
2020-04-07,6044,5392,95943,8419000,1
2020-04-08,5575,5991,101934,8419000,1
2020-04-09,5070,5563,107497,8419000,1
2020-04-10,4510,5052,112549,8419000,1
2020-04-11,3732,4437,116986,8419000,1
2020-04-12,2887,3710,120696,8419000,1
2020-04-13,3311,3310,124006,8419000,1
2020-04-14,4144,3447,127453,8419000,1
2020-04-15,3876,3777,131230,8419000,1
2020-04-16,3530,3850,135080,8419000,1
2020-04-17,3586,3664,138744,8419000,1
2020-04-18,2172,3096,141840,8419000,1
2020-04-19,2343,2700,144540,8419000,1
2020-04-20,3792,2769,147309,8419000,1
2020-04-21,3062,3066,150375,8419000,1
2020-04-22,3446,3433,153808,8419000,1
2020-04-23,2841,3116,156924,8419000,1
2020-04-24,2535,2941,159865,8419000,1
2020-04-25,1595,2324,162189,8419000,1
2020-04-26,1003,1711,163900,8419000,1
2020-04-27,2290,1629,165529,8419000,1
2020-04-28,2726,2006,167535,8419000,1
2020-04-29,2340,2452,169987,8419000,1
2020-04-30,2022,2363,172350,8419000,1
2020-05-01,1887,2083,174433,8419000,1
2020-05-02,1058,1656,176089,8419000,1
2020-05-03,787,1244,177333,8419000,1
2020-05-04,1550,1132,178465,8419000,1
2020-05-05,1512,1283,179748,8419000,1
2020-05-06,1397,1486,181234,8419000,1
2020-05-07,1238,1382,182616,8419000,1
2020-05-08,1079,1238,183854,8419000,1
2020-05-09,657,991,184845,8419000,1
2020-05-10,457,731,185576,8419000,1
2020-05-11,1231,782,186358,8419000,1
2020-05-12,1285,991,187349,8419000,1
2020-05-13,1333,1283,188632,8419000,1
2020-05-14,1110,1243,189875,8419000,1
2020-05-15,873,1105,190980,8419000,1
2020-05-16,485,823,191803,8419000,1
2020-05-17,360,573,192376,8419000,1
2020-05-18,895,580,192956,8419000,1
2020-05-19,1003,753,193709,8419000,1
2020-05-20,1077,992,194701,8419000,1
2020-05-21,1069,1050,195751,8419000,1
2020-05-22,1036,1061,196812,8419000,1
2020-05-23,455,853,197665,8419000,1
2020-05-24,467,653,198318,8419000,1
2020-05-25,464,462,198780,8419000,1
2020-05-26,1050,660,199440,8419000,1
2020-05-27,741,752,200192,8419000,1
2020-05-28,646,812,201004,8419000,1
2020-05-29,639,675,201679,8419000,1
2020-05-30,346,544,202223,8419000,1
2020-05-31,230,405,202628,8419000,1
2020-06-01,686,421,203049,8419000,1
2020-06-02,570,495,203544,8419000,1
2020-06-03,515,590,204134,8419000,1
2020-06-04,517,534,204668,8419000,1
2020-06-05,402,478,205146,8419000,1
2020-06-06,247,389,205535,8419000,1
2020-06-07,197,282,205817,8419000,1
2020-06-08,447,297,206114,8419000,1
2020-06-09,419,354,206468,8419000,1
2020-06-10,363,410,206878,8419000,1
2020-06-11,363,382,207260,8419000,1
2020-06-12,409,378,207638,8419000,1
2020-06-13,196,323,207961,8419000,1
2020-06-14,180,262,208223,8419000,1
2020-06-15,380,252,208475,8419000,NA
2020-06-16,419,326,208801,8419000,NA
2020-06-17,356,385,209186,8419000,NA
2020-06-18,378,384,209570,8419000,NA
2020-06-19,361,365,209935,8419000,NA
2020-06-20,203,314,210249,8419000,NA
2020-06-21,172,245,210494,8419000,NA
2020-06-22,402,259,210753,8419000,NA
2020-06-23,381,318,211071,8419000,NA
2020-06-24,381,388,211459,8419000,NA
2020-06-25,298,353,211812,8419000,NA
2020-06-26,317,332,212144,8419000,NA
2020-06-27,206,274,212418,8419000,NA
2020-06-28,201,241,212659,8419000,NA
2020-06-29,437,281,212940,8419000,NA
2020-06-30,441,360,213300,8419000,NA
2020-07-01,395,424,213724,8419000,NA
2020-07-02,416,417,214141,8419000,NA
2020-07-03,234,348,214489,8419000,NA
2020-07-04,120,257,214746,8419000,NA
2020-07-05,155,170,214916,8419000,NA
2020-07-06,431,235,215151,8419000,NA
2020-07-07,461,349,215500,8419000,NA
2020-07-08,437,443,215943,8419000,NA
2020-07-09,391,430,216373,8419000,NA
2020-07-10,306,378,216751,8419000,NA
2020-07-11,259,319,217070,8419000,NA
2020-07-12,223,263,217333,8419000,NA
2020-07-13,483,322,217655,8419000,NA
2020-07-14,402,369,218024,8419000,NA
2020-07-15,440,442,218466,8419000,NA
2020-07-16,411,418,218884,8419000,NA
2020-07-17,413,421,219305,8419000,NA
2020-07-18,216,347,219652,8419000,NA
2020-07-19,176,268,219920,8419000,NA
2020-07-20,401,264,220184,8419000,NA
2020-07-21,340,306,220490,8419000,NA
2020-07-22,329,357,220847,8419000,NA
2020-07-23,308,326,221173,8419000,NA
2020-07-24,298,312,221485,8419000,NA
2020-07-25,153,253,221738,8419000,NA
2020-07-26,140,197,221935,8419000,NA
2020-07-27,312,202,222137,8419000,NA
2020-07-28,313,255,222392,8419000,NA
2020-07-29,287,304,222696,8419000,NA
2020-07-30,274,291,222987,8419000,NA
2020-07-31,262,274,223261,8419000,NA
2020-08-01,189,242,223503,8419000,NA
2020-08-02,135,195,223698,8419000,NA
2020-08-03,348,224,223922,8419000,NA
2020-08-04,187,223,224145,8419000,NA
2020-08-05,298,278,224423,8419000,NA
2020-08-06,288,258,224681,8419000,NA
2020-08-07,255,280,224961,8419000,NA
2020-08-08,160,234,225195,8419000,NA
2020-08-09,133,183,225378,8419000,NA
2020-08-10,312,202,225580,8419000,NA
2020-08-11,263,236,225816,8419000,NA
2020-08-12,320,298,226114,8419000,NA
2020-08-13,276,286,226400,8419000,NA
2020-08-14,277,291,226691,8419000,NA
2020-08-15,151,235,226926,8419000,NA
2020-08-16,140,189,227115,8419000,NA
2020-08-17,333,208,227323,8419000,NA
2020-08-18,283,252,227575,8419000,NA
2020-08-19,257,291,227866,8419000,NA
2020-08-20,227,256,228122,8419000,NA
2020-08-21,252,245,228367,8419000,NA
2020-08-22,136,205,228572,8419000,NA
2020-08-23,150,179,228751,8419000,NA
2020-08-24,297,194,228945,8419000,NA
2020-08-25,283,243,229188,8419000,NA
2020-08-26,313,298,229486,8419000,NA
2020-08-27,274,290,229776,8419000,NA
2020-08-28,280,289,230065,8419000,NA
2020-08-29,128,227,230292,8419000,NA
2020-08-30,186,198,230490,8419000,NA
2020-08-31,315,210,230700,8419000,NA
2020-09-01,294,265,230965,8419000,NA
2020-09-02,271,293,231258,8419000,NA
2020-09-03,273,279,231537,8419000,NA
2020-09-04,230,258,231795,8419000,NA
2020-09-05,156,220,232015,8419000,NA
2020-09-06,207,198,232213,8419000,NA
2020-09-07,217,193,232406,8419000,NA
2020-09-08,393,272,232678,8419000,NA
2020-09-09,353,321,232999,8419000,NA
2020-09-10,323,356,233355,8419000,NA
2020-09-11,313,330,233685,8419000,NA
2020-09-12,202,279,233964,8419000,NA
2020-09-13,263,259,234223,8419000,NA
2020-09-14,461,309,234532,8419000,NA
2020-09-15,415,380,234912,8419000,NA
2020-09-16,456,444,235356,8419000,NA
2020-09-17,441,437,235793,8419000,NA
2020-09-18,292,396,236189,8419000,NA
2020-09-19,216,316,236505,8419000,NA
2020-09-20,220,243,236748,8419000,NA
2020-09-21,558,331,237079,8419000,NA
2020-09-22,497,425,237504,8419000,NA
2020-09-23,612,556,238060,8419000,NA
2020-09-24,542,550,238610,8419000,NA
2020-09-25,463,539,239149,8419000,NA
2020-09-26,280,428,239577,8419000,NA
2020-09-27,382,375,239952,8419000,NA
2020-09-28,437,366,240318,8419000,NA
2020-09-29,723,514,240832,8419000,NA
2020-09-30,605,588,241420,8419000,NA
2020-10-01,705,678,242098,8419000,2
2020-10-02,605,638,242736,8419000,2
2020-10-03,299,536,243272,8419000,2
2020-10-04,335,413,243685,8419000,2
2020-10-05,766,467,244152,8419000,2
2020-10-06,571,557,244709,8419000,2
2020-10-07,542,626,245335,8419000,2
2020-10-08,525,546,245881,8419000,2
2020-10-09,524,530,246411,8419000,2
2020-10-10,314,454,246865,8419000,2
2020-10-11,281,373,247238,8419000,2
2020-10-12,515,370,247608,8419000,2
2020-10-13,588,461,248069,8419000,2
2020-10-14,583,562,248631,8419000,2
2020-10-15,604,592,249223,8419000,2
2020-10-16,503,563,249786,8419000,2
2020-10-17,366,491,250277,8419000,2
2020-10-18,412,427,250704,8419000,2
2020-10-19,626,468,251172,8419000,2
2020-10-20,601,546,251718,8419000,2
2020-10-21,654,627,252345,8419000,2
2020-10-22,759,671,253016,8419000,2
2020-10-23,601,671,253687,8419000,2
2020-10-24,386,582,254269,8419000,2
2020-10-25,362,450,254719,8419000,2
2020-10-26,695,481,255200,8419000,2
2020-10-27,742,600,255800,8419000,2
2020-10-28,783,740,256540,8419000,2
2020-10-29,621,715,257255,8419000,2
2020-10-30,654,686,257941,8419000,2
2020-10-31,403,559,258500,8419000,2
2020-11-01,501,519,259019,8419000,2
2020-11-02,953,619,259638,8419000,2
2020-11-03,903,786,260424,8419000,2
2020-11-04,1113,990,261414,8419000,2
2020-11-05,1139,1052,262466,8419000,2
2020-11-06,1037,1096,263562,8419000,2
2020-11-07,845,1007,264569,8419000,2
2020-11-08,788,890,265459,8419000,2
2020-11-09,1545,1059,266518,8419000,2
2020-11-10,1599,1311,267829,8419000,2
2020-11-11,1540,1561,269390,8419000,2
2020-11-12,1501,1547,270937,8419000,2
2020-11-13,1494,1512,272449,8419000,2
2020-11-14,1026,1340,273789,8419000,2
2020-11-15,896,1139,274928,8419000,2
2020-11-16,1832,1251,276179,8419000,2
2020-11-17,1730,1486,277665,8419000,2
2020-11-18,1753,1772,279437,8419000,2
2020-11-19,1857,1780,281217,8419000,2
2020-11-20,1773,1794,283011,8419000,2
2020-11-21,1290,1640,284651,8419000,2
2020-11-22,1148,1404,286055,8419000,2
2020-11-23,2317,1585,287640,8419000,2
2020-11-24,2074,1846,289486,8419000,2
2020-11-25,2370,2254,291740,8419000,2
2020-11-26,817,1754,293494,8419000,2
2020-11-27,2298,1828,295322,8419000,2
2020-11-28,1839,1651,296973,8419000,2
2020-11-29,1891,2009,298982,8419000,2
2020-11-30,2895,2208,301190,8419000,2
2020-12-01,3308,2698,303888,8419000,2
2020-12-02,3129,3111,306999,8419000,2
2020-12-03,2945,3127,310126,8419000,2
2020-12-04,2816,2963,313089,8419000,2
2020-12-05,1887,2549,315638,8419000,2
2020-12-06,1755,2153,317791,8419000,2
2020-12-07,3304,2315,320106,8419000,2
2020-12-08,3059,2706,322812,8419000,2
2020-12-09,3106,3156,325968,8419000,2
2020-12-10,3149,3105,329073,8419000,2
2020-12-11,2980,3078,332151,8419000,2
2020-12-12,2206,2778,334929,8419000,2
2020-12-13,2176,2454,337383,8419000,2
2020-12-14,3580,2654,340037,8419000,2
2020-12-15,3681,3146,343183,8419000,2
2020-12-16,2787,3349,346532,8419000,2
2020-12-17,1926,2798,349330,8419000,2
2020-12-18,3427,2713,352043,8419000,2
2020-12-19,2557,2637,354680,8419000,2
2020-12-20,2346,2777,357457,8419000,2
2020-12-21,4338,3080,360537,8419000,2
2020-12-22,4102,3595,364132,8419000,2
2020-12-23,3844,4095,368227,8419000,2
2020-12-24,3015,3654,371881,8419000,2
2020-12-25,1046,2635,374516,8419000,2
2020-12-26,3454,2505,377021,8419000,2
2020-12-27,2888,2463,379484,8419000,2
2020-12-28,5392,3911,383395,8419000,2
2020-12-29,5206,4495,387890,8419000,2
2020-12-30,4985,5194,393084,8419000,2
2020-12-31,3393,4528,397612,8419000,2
2021-01-01,1340,3239,400851,8419000,2
2021-01-02,4202,2978,403829,8419000,2
2021-01-03,3465,3002,406831,8419000,2
2021-01-04,6604,4757,411588,8419000,2
2021-01-05,6156,5408,416996,8419000,2
2021-01-06,5684,6148,423144,8419000,2
2021-01-07,5444,5761,428905,8419000,2
2021-01-08,5298,5475,434380,8419000,2
2021-01-09,3691,4811,439191,8419000,2
2021-01-10,3199,4063,443254,8419000,2
2021-01-11,5914,4268,447522,8419000,2
2021-01-12,5235,4783,452305,8419000,2
2021-01-13,5177,5442,457747,8419000,2
2021-01-14,5257,5223,462970,8419000,2
2021-01-15,4844,5093,468063,8419000,2
2021-01-16,3479,4527,472590,8419000,2
2021-01-17,2919,3747,476337,8419000,2
2021-01-18,4642,3680,480017,8419000,2
2021-01-19,5140,4234,484251,8419000,2
2021-01-20,4909,4897,489148,8419000,2
2021-01-21,4937,4995,494143,8419000,2
2021-01-22,4715,4854,498997,8419000,2
2021-01-23,3461,4371,503368,8419000,2
2021-01-24,2930,3702,507070,8419000,2
2021-01-25,5817,4069,511139,8419000,2
2021-01-26,4866,4538,515677,8419000,2
2021-01-27,5006,5230,520907,8419000,2
2021-01-28,4794,4889,525796,8419000,2
2021-01-29,3671,4490,530286,8419000,2
2021-01-30,2877,3781,534067,8419000,2
2021-01-31,2894,3147,537214,8419000,2
2021-02-01,980,2250,539464,8419000,2
2021-02-02,2659,2178,541642,8419000,2
2021-02-03,5145,2928,544570,8419000,2
2021-02-04,4851,4218,548788,8419000,2
2021-02-05,4157,4718,553506,8419000,2
2021-02-06,3080,4029,557535,8419000,2
2021-02-07,1645,2961,560496,8419000,2
2021-02-08,4431,3052,563548,8419000,2
2021-02-09,3735,3270,566818,8419000,2
2021-02-10,3778,3981,570799,8419000,2
2021-02-11,3415,3643,574442,8419000,2
2021-02-12,3314,3502,577944,8419000,2
2021-02-13,2206,2978,580922,8419000,2
2021-02-14,1894,2471,583393,8419000,2
2021-02-15,2862,2321,585714,8419000,2
2021-02-16,3724,2827,588541,8419000,2
2021-02-17,3436,3341,591882,8419000,2
2021-02-18,2048,3069,594951,8419000,2
2021-02-19,3018,2834,597785,8419000,2
2021-02-20,2494,2520,600305,8419000,2
2021-02-21,2285,2599,602904,8419000,2
2021-02-22,3625,2801,605705,8419000,2
2021-02-23,3473,3128,608833,8419000,2
2021-02-24,3464,3521,612354,8419000,2
2021-02-25,3479,3472,615826,8419000,2
2021-02-26,3242,3395,619221,8419000,2
2021-02-27,2017,2913,622134,8419000,2
2021-02-28,2037,2432,624566,8419000,2
2021-03-01,3726,2593,627159,8419000,2
2021-03-02,3108,2957,630116,8419000,2
2021-03-03,3243,3359,633475,8419000,2
2021-03-04,3118,3156,636631,8419000,2
2021-03-05,2886,3082,639713,8419000,2
2021-03-06,2043,2682,642395,8419000,2
2021-03-07,1875,2268,644663,8419000,2
2021-03-08,3401,2440,647103,8419000,2
2021-03-09,3342,2873,649976,8419000,2
2021-03-10,3203,3315,653291,8419000,2
2021-03-11,3107,3217,656508,8419000,2
2021-03-12,3204,3171,659679,8419000,2
2021-03-13,2174,2828,662507,8419000,2
2021-03-14,1926,2435,664942,8419000,2
2021-03-15,3395,2498,667440,8419000,2
2021-03-16,3195,2839,670279,8419000,2
2021-03-17,3174,3255,673534,8419000,2
2021-03-18,2921,3097,676631,8419000,2
2021-03-19,3048,3048,679679,8419000,2
2021-03-20,2160,2710,682389,8419000,2
2021-03-21,2093,2434,684823,8419000,2
2021-03-22,3882,2712,687535,8419000,2
2021-03-23,3254,3076,690611,8419000,2
2021-03-24,3452,3529,694140,8419000,2
2021-03-25,3798,3501,697641,8419000,2
2021-03-26,3416,3555,701196,8419000,2
2021-03-27,2221,3145,704341,8419000,2
2021-03-28,1750,2462,706803,8419000,2
2021-03-29,3558,2510,709313,8419000,2
2021-03-30,3185,2831,712144,8419000,2
2021-03-31,3185,3309,715453,8419000,2
2021-04-01,2866,3079,718532,8419000,2
2021-04-02,2620,2890,721422,8419000,2
2021-04-03,2050,2512,723934,8419000,2
2021-04-04,1466,2045,725979,8419000,2
2021-04-05,3270,2262,728241,8419000,2
2021-04-06,3003,2580,730821,8419000,2
2021-04-07,2763,3012,733833,8419000,2
2021-04-08,2575,2780,736613,8419000,2
2021-04-09,2467,2602,739215,8419000,2
2021-04-10,1723,2255,741470,8419000,2
2021-04-11,1315,1835,743305,8419000,2
2021-04-12,2535,1858,745163,8419000,2
2021-04-13,2363,2071,747234,8419000,2
2021-04-14,2241,2380,749614,8419000,2
2021-04-15,2016,2207,751821,8419000,2
2021-04-16,1830,2029,753850,8419000,2
2021-04-17,1275,1707,755557,8419000,2
2021-04-18,1050,1385,756942,8419000,2
2021-04-19,1884,1403,758345,8419000,2
2021-04-20,1606,1513,759858,8419000,2
2021-04-21,1423,1638,761496,8419000,2
2021-04-22,1360,1463,762959,8419000,2
2021-04-23,1288,1357,764316,8419000,2
2021-04-24,854,1167,765483,8419000,2
2021-04-25,754,965,766448,8419000,2
2021-04-26,1373,994,767442,8419000,2
2021-04-27,1136,1088,768530,8419000,2
2021-04-28,1211,1240,769770,8419000,2
2021-04-29,1053,1133,770903,8419000,2
2021-04-30,950,1071,771974,8419000,2
2021-05-01,578,860,772834,8419000,2
2021-05-02,568,699,773533,8419000,2
2021-05-03,936,694,774227,8419000,2
2021-05-04,876,793,775020,8419000,2
2021-05-05,776,863,775883,8419000,2
2021-05-06,785,812,776695,8419000,2
2021-05-07,715,759,777454,8419000,2
2021-05-08,384,628,778082,8419000,2
2021-05-09,343,481,778563,8419000,2
2021-05-10,654,460,779023,8419000,2
2021-05-11,628,542,779565,8419000,2
2021-05-12,593,625,780190,8419000,2
2021-05-13,516,579,780769,8419000,2
2021-05-14,487,532,781301,8419000,2
2021-05-15,292,432,781733,8419000,2
2021-05-16,280,353,782086,8419000,2
2021-05-17,453,342,782428,8419000,2
2021-05-18,415,383,782811,8419000,2
2021-05-19,377,415,783226,8419000,2
2021-05-20,395,396,783622,8419000,2
2021-05-21,349,374,783996,8419000,2
2021-05-22,233,326,784322,8419000,2
2021-05-23,187,256,784578,8419000,2
2021-05-24,355,258,784836,8419000,2
2021-05-25,305,282,785118,8419000,2
2021-05-26,249,303,785421,8419000,2
2021-05-27,257,270,785691,8419000,2
2021-05-28,210,239,785930,8419000,2
2021-05-29,126,198,786128,8419000,2
2021-05-30,118,151,786279,8419000,2
2021-05-31,117,120,786399,8419000,2
2021-06-01,289,175,786574,8419000,NA
2021-06-02,244,217,786791,8419000,NA
2021-06-03,206,246,787037,8419000,NA
2021-06-04,225,225,787262,8419000,NA
2021-06-05,142,191,787453,8419000,NA
2021-06-06,130,166,787619,8419000,NA
2021-06-07,221,164,787783,8419000,NA
2021-06-08,176,176,787959,8419000,NA
2021-06-09,211,203,788162,8419000,NA
2021-06-10,156,181,788343,8419000,NA
2021-06-11,189,185,788528,8419000,NA
2021-06-12,121,155,788683,8419000,NA
2021-06-13,115,142,788825,8419000,NA
2021-06-14,182,139,788964,8419000,NA
2021-06-15,179,159,789123,8419000,NA
2021-06-16,173,178,789301,8419000,NA
2021-06-17,188,180,789481,8419000,NA
2021-06-18,160,174,789655,8419000,NA
2021-06-19,107,152,789807,8419000,NA
2021-06-20,96,121,789928,8419000,NA
2021-06-21,168,124,790052,8419000,NA
2021-06-22,171,145,790197,8419000,NA
2021-06-23,187,175,790372,8419000,NA
2021-06-24,175,178,790550,8419000,NA
2021-06-25,180,181,790731,8419000,NA
2021-06-26,118,158,790889,8419000,NA
2021-06-27,110,136,791025,8419000,NA
2021-06-28,206,145,791170,8419000,NA
2021-06-29,212,176,791346,8419000,NA
2021-06-30,226,215,791561,8419000,NA
2021-07-01,204,214,791775,8419000,3
2021-07-02,232,221,791996,8419000,3
2021-07-03,146,194,792190,8419000,3
2021-07-04,124,167,792357,8419000,3
2021-07-05,187,152,792509,8419000,3
2021-07-06,364,225,792734,8419000,3
2021-07-07,402,318,793052,8419000,3
2021-07-08,369,378,793430,8419000,3
2021-07-09,370,380,793810,8419000,3
2021-07-10,238,326,794136,8419000,3
2021-07-11,272,293,794429,8419000,3
2021-07-12,477,329,794758,8419000,3
2021-07-13,457,402,795160,8419000,3
2021-07-14,549,494,795654,8419000,3
2021-07-15,552,519,796173,8419000,3
2021-07-16,557,553,796726,8419000,3
2021-07-17,340,483,797209,8419000,3
2021-07-18,394,430,797639,8419000,3
2021-07-19,813,516,798155,8419000,3
2021-07-20,711,639,798794,8419000,3
2021-07-21,894,806,799600,8419000,3
2021-07-22,975,860,800460,8419000,3
2021-07-23,919,929,801389,8419000,3
2021-07-24,552,815,802204,8419000,3
2021-07-25,635,702,802906,8419000,3
2021-07-26,1228,805,803711,8419000,3
2021-07-27,1199,1021,804732,8419000,3
2021-07-28,1243,1223,805955,8419000,3
2021-07-29,1290,1244,807199,8419000,3
2021-07-30,1282,1272,808471,8419000,3
2021-07-31,850,1141,809612,8419000,3
2021-08-01,831,988,810600,8419000,3
2021-08-02,1569,1083,811683,8419000,3
2021-08-03,1585,1328,813011,8419000,3
2021-08-04,1614,1589,814600,8419000,3
2021-08-05,1528,1576,816176,8419000,3
2021-08-06,1577,1573,817749,8419000,3
2021-08-07,1149,1418,819167,8419000,3
2021-08-08,1071,1266,820433,8419000,3
2021-08-09,1892,1371,821804,8419000,3
2021-08-10,1666,1543,823347,8419000,3
2021-08-11,1753,1770,825117,8419000,3
2021-08-12,1758,1726,826843,8419000,3
2021-08-13,1601,1704,828547,8419000,3
2021-08-14,1048,1469,830016,8419000,3
2021-08-15,1144,1264,831280,8419000,3
2021-08-16,1928,1373,832653,8419000,3
2021-08-17,1745,1606,834259,8419000,3
2021-08-18,1814,1829,836088,8419000,3
2021-08-19,1694,1751,837839,8419000,3
2021-08-20,1561,1690,839529,8419000,3
2021-08-21,1091,1449,840978,8419000,3
2021-08-22,718,1123,842101,8419000,3
2021-08-23,1953,1254,843355,8419000,3
2021-08-24,1837,1503,844858,8419000,3
2021-08-25,1787,1859,846717,8419000,3
2021-08-26,1644,1756,848473,8419000,3
2021-08-27,1451,1627,850100,8419000,3
2021-08-28,985,1360,851460,8419000,3
2021-08-29,989,1142,852602,8419000,3
2021-08-30,1840,1271,853873,8419000,3
2021-08-31,1623,1484,855357,8419000,3
2021-09-01,1559,1674,857031,8419000,3
2021-09-02,1431,1538,858569,8419000,3
2021-09-03,1422,1471,860040,8419000,3
2021-09-04,905,1253,861293,8419000,3
2021-09-05,954,1094,862387,8419000,3
2021-09-06,943,934,863321,8419000,3
2021-09-07,1571,1156,864477,8419000,3
2021-09-08,1592,1369,865846,8419000,3
2021-09-09,1713,1625,867471,8419000,3
2021-09-10,1548,1618,869089,8419000,3
2021-09-11,1037,1433,870522,8419000,3
2021-09-12,1213,1266,871788,8419000,3
2021-09-13,1738,1329,873117,8419000,3
2021-09-14,1642,1531,874648,8419000,3
2021-09-15,1610,1663,876311,8419000,3
2021-09-16,1388,1547,877858,8419000,3
2021-09-17,1525,1508,879366,8419000,3
2021-09-18,956,1290,880656,8419000,3
2021-09-19,1057,1179,881835,8419000,3
2021-09-20,1641,1218,883053,8419000,3
2021-09-21,1302,1333,884386,8419000,3
2021-09-22,1415,1453,885839,8419000,3
2021-09-23,1292,1336,887175,8419000,3
2021-09-24,1222,1310,888485,8419000,3
2021-09-25,814,1109,889594,8419000,3
2021-09-26,856,964,890558,8419000,3
2021-09-27,1391,1020,891578,8419000,3
2021-09-28,1118,1122,892700,8419000,3
2021-09-29,1096,1202,893902,8419000,3
2021-09-30,1139,1118,895020,8419000,3
2021-10-01,1087,1107,896127,8419000,3
2021-10-02,681,969,897096,8419000,3
2021-10-03,907,892,897988,8419000,3
2021-10-04,1271,953,898941,8419000,3
2021-10-05,1270,1149,900090,8419000,3
2021-10-06,1146,1229,901319,8419000,3
2021-10-07,1079,1165,902484,8419000,3
2021-10-08,1012,1079,903563,8419000,3
2021-10-09,612,901,904464,8419000,3
2021-10-10,688,771,905235,8419000,3
2021-10-11,935,745,905980,8419000,3
2021-10-12,1143,922,906902,8419000,3
2021-10-13,1111,1063,907965,8419000,3
2021-10-14,1025,1093,909058,8419000,3
2021-10-15,886,1007,910065,8419000,3
2021-10-16,489,800,910865,8419000,3
2021-10-17,586,654,911519,8419000,3
2021-10-18,874,650,912169,8419000,3
2021-10-19,798,753,912922,8419000,3
2021-10-20,800,824,913746,8419000,3
2021-10-21,811,803,914549,8419000,3
2021-10-22,695,769,915318,8419000,3
2021-10-23,451,652,915970,8419000,3
2021-10-24,444,530,916500,8419000,3
2021-10-25,896,597,917097,8419000,3
2021-10-26,597,646,917743,8419000,3
2021-10-27,758,750,918493,8419000,3
2021-10-28,738,698,919191,8419000,3
2021-10-29,641,712,919903,8419000,3
2021-10-30,399,593,920496,8419000,3
2021-10-31,446,495,920991,8419000,3
2021-11-01,779,541,921532,8419000,4
2021-11-02,805,677,922209,8419000,4
2021-11-03,825,803,923012,8419000,4
2021-11-04,906,845,923857,8419000,4
2021-11-05,769,833,924690,8419000,4
2021-11-06,508,728,925418,8419000,4
2021-11-07,542,606,926024,8419000,4
2021-11-08,1135,728,926752,8419000,4
2021-11-09,1037,905,927657,8419000,4
2021-11-10,1048,1073,928730,8419000,4
2021-11-11,874,986,929716,8419000,4
2021-11-12,1028,983,930699,8419000,4
2021-11-13,614,839,931538,8419000,4
2021-11-14,686,776,932314,8419000,4
2021-11-15,1263,854,933168,8419000,4
2021-11-16,1272,1074,934242,8419000,4
2021-11-17,1329,1288,935530,8419000,4
2021-11-18,1310,1304,936834,8419000,4
2021-11-19,1184,1274,938108,8419000,4
2021-11-20,826,1107,939215,8419000,4
2021-11-21,840,950,940165,8419000,4
2021-11-22,1528,1065,941230,8419000,4
2021-11-23,1378,1249,942479,8419000,4
2021-11-24,1416,1441,943920,8419000,4
2021-11-25,531,1108,945028,8419000,4
2021-11-26,1171,1039,946067,8419000,4
2021-11-27,971,891,946958,8419000,4
2021-11-28,1060,1067,948025,8419000,4
2021-11-29,2328,1453,949478,8419000,4
2021-11-30,2006,1798,951276,8419000,4
2021-12-01,2180,2171,953447,8419000,4
2021-12-02,2109,2098,955545,8419000,4
2021-12-03,1893,2061,957606,8419000,4
2021-12-04,1321,1774,959380,8419000,4
2021-12-05,1403,1539,960919,8419000,4
2021-12-06,2798,1841,962760,8419000,4
2021-12-07,2919,2373,965133,8419000,4
2021-12-08,3136,2951,968084,8419000,4
2021-12-09,3021,3025,971109,8419000,4
2021-12-10,3086,3081,974190,8419000,4
2021-12-11,2158,2755,976945,8419000,4
2021-12-12,2795,2680,979625,8419000,4
2021-12-13,7528,4160,983785,8419000,4
2021-12-14,10865,7063,990848,8419000,4
2021-12-15,13164,10519,1001367,8419000,4
2021-12-16,13851,12627,1013994,8419000,4
2021-12-17,13544,13520,1027514,8419000,4
2021-12-18,9945,12447,1039961,8419000,4
2021-12-19,10548,11346,1051307,8419000,4
2021-12-20,27939,16144,1067451,8419000,4
2021-12-21,30384,22957,1090408,8419000,4
2021-12-22,31372,29898,1120306,8419000,4
2021-12-23,31790,31182,1151488,8419000,4
2021-12-24,17452,26871,1178359,8419000,4
2021-12-25,7788,19010,1197369,8419000,4
2021-12-26,22969,16070,1213439,8419000,4
2021-12-27,51202,27320,1240759,8419000,4
2021-12-28,49616,41262,1282021,8419000,4
2021-12-29,50405,50408,1332429,8419000,4
2021-12-30,47350,49124,1381553,8419000,4
2021-12-31,29053,42269,1423822,8419000,4
2022-01-01,12056,29486,1453308,8419000,4
2022-01-02,32460,24523,1477831,8419000,4
2022-01-03,54873,33130,1510961,8419000,4
2022-01-04,49076,45470,1556431,8419000,4
2022-01-05,40154,48034,1604465,8419000,4
2022-01-06,36328,41853,1646318,8419000,4
2022-01-07,23205,33229,1679547,8419000,4
2022-01-08,16177,25237,1704784,8419000,4
2022-01-09,14334,17905,1722689,8419000,4
2022-01-10,25003,18505,1741194,8419000,4
2022-01-11,18450,19262,1760456,8419000,4
2022-01-12,18441,20631,1781087,8419000,4
2022-01-13,16092,17661,1798748,8419000,4
2022-01-14,13288,15940,1814688,8419000,4
2022-01-15,6763,12048,1826736,8419000,4
2022-01-16,6897,8983,1835719,8419000,4
2022-01-17,9822,7827,1843546,8419000,4
2022-01-18,10918,9212,1852758,8419000,4
2022-01-19,9036,9925,1862683,8419000,4
2022-01-20,7036,8997,1871680,8419000,4
2022-01-21,5787,7286,1878966,8419000,4
2022-01-22,3630,5484,1884450,8419000,4
2022-01-23,3397,4271,1888721,8419000,4
2022-01-24,6018,4348,1893069,8419000,4
2022-01-25,4763,4726,1897795,8419000,4
2022-01-26,4199,4993,1902788,8419000,4
2022-01-27,3634,4199,1906987,8419000,4
2022-01-28,2722,3518,1910505,8419000,4
2022-01-29,512,2289,1912794,8419000,4
2022-01-30,1424,1553,1914347,8419000,4
2022-01-31,3111,1682,1916029,8419000,4
2022-02-01,2239,2258,1918287,8419000,4
2022-02-02,2325,2558,1920845,8419000,4
2022-02-03,2001,2188,1923033,8419000,4
2022-02-04,1539,1955,1924988,8419000,4
2022-02-05,946,1495,1926483,8419000,4
2022-02-06,866,1117,1927600,8419000,4
2022-02-07,1602,1138,1928738,8419000,4
2022-02-08,1515,1328,1930066,8419000,4
2022-02-09,1316,1478,1931544,8419000,4
2022-02-10,1224,1352,1932896,8419000,4
2022-02-11,982,1174,1934070,8419000,4
2022-02-12,635,947,1935017,8419000,4
2022-02-13,457,691,1935708,8419000,4
2022-02-14,1016,703,1936411,8419000,4
2022-02-15,939,804,1937215,8419000,4
2022-02-16,936,964,1938179,8419000,4
2022-02-17,832,902,1939081,8419000,4
2022-02-18,663,810,1939891,8419000,4
2022-02-19,425,640,1940531,8419000,4
2022-02-20,381,490,1941021,8419000,4
2022-02-21,559,455,1941476,8419000,4
2022-02-22,685,542,1942018,8419000,4
2022-02-23,703,649,1942667,8419000,4
2022-02-24,660,683,1943350,8419000,4
2022-02-25,537,633,1943983,8419000,4
2022-02-26,337,511,1944494,8419000,4
2022-02-27,360,411,1944905,8419000,4
2022-02-28,707,468,1945373,8419000,4
2022-03-01,611,559,1945932,8419000,4
2022-03-02,641,653,1946585,8419000,4
2022-03-03,587,613,1947198,8419000,4
2022-03-04,460,563,1947761,8419000,4
2022-03-05,317,455,1948216,8419000,4
2022-03-06,339,372,1948588,8419000,4
2022-03-07,655,437,1949025,8419000,4
2022-03-08,681,558,1949583,8419000,4
2022-03-09,626,654,1950237,8419000,4
2022-03-10,699,669,1950906,8419000,4
2022-03-11,604,643,1951549,8419000,4
2022-03-12,298,534,1952083,8419000,4
2022-03-13,434,445,1952528,8419000,4
2022-03-14,900,544,1953072,8419000,4
2022-03-15,847,727,1953799,8419000,NA
2022-03-16,872,873,1954672,8419000,NA
2022-03-17,752,824,1955496,8419000,NA
2022-03-18,802,809,1956305,8419000,NA
2022-03-19,448,667,1956972,8419000,NA
2022-03-20,654,635,1957607,8419000,NA
2022-03-21,1311,804,1958411,8419000,NA
2022-03-22,1286,1084,1959495,8419000,NA
2022-03-23,1269,1289,1960784,8419000,NA
2022-03-24,1177,1244,1962028,8419000,NA
2022-03-25,1094,1180,1963208,8419000,NA
2022-03-26,679,983,1964191,8419000,NA
2022-03-27,777,850,1965041,8419000,NA
2022-03-28,1512,989,1966030,8419000,NA
2022-03-29,1436,1242,1967272,8419000,NA
2022-03-30,1513,1487,1968759,8419000,NA
2022-03-31,1509,1486,1970245,8419000,NA
2022-04-01,1333,1452,1971697,8419000,NA
2022-04-02,876,1239,1972936,8419000,NA
2022-04-03,900,1036,1973972,8419000,NA
2022-04-04,2146,1307,1975279,8419000,NA
2022-04-05,1965,1670,1976949,8419000,NA
2022-04-06,2092,2068,1979017,8419000,NA
2022-04-07,2002,2020,1981037,8419000,NA
2022-04-08,1878,1991,1983028,8419000,NA
2022-04-09,1169,1683,1984711,8419000,NA
2022-04-10,1189,1412,1986123,8419000,NA
2022-04-11,2592,1650,1987773,8419000,NA
2022-04-12,2418,2066,1989839,8419000,NA
2022-04-13,2600,2537,1992376,8419000,NA
2022-04-14,2298,2439,1994815,8419000,NA
2022-04-15,1989,2296,1997111,8419000,NA
2022-04-16,1201,1829,1998940,8419000,NA
2022-04-17,955,1382,2000322,8419000,NA
2022-04-18,2333,1496,2001818,8419000,NA
2022-04-19,2286,1858,2003676,8419000,NA
2022-04-20,2165,2261,2005937,8419000,NA
2022-04-21,1984,2145,2008082,8419000,NA
2022-04-22,1813,1987,2010069,8419000,NA
2022-04-23,1410,1736,2011805,8419000,NA
2022-04-24,1456,1560,2013365,8419000,NA
2022-04-25,2914,1927,2015292,8419000,NA
2022-04-26,2926,2432,2017724,8419000,NA
2022-04-27,2773,2871,2020595,8419000,NA
2022-04-28,2650,2783,2023378,8419000,NA
2022-04-29,2766,2730,2026108,8419000,NA
2022-04-30,1607,2341,2028449,8419000,NA
2022-05-01,1856,2076,2030525,8419000,NA
2022-05-02,3858,2440,2032965,8419000,NA
2022-05-03,3751,3155,2036120,8419000,NA
2022-05-04,3697,3769,2039889,8419000,NA
2022-05-05,3538,3662,2043551,8419000,NA
2022-05-06,3065,3433,2046984,8419000,NA
2022-05-07,1843,2815,2049799,8419000,NA
2022-05-08,1937,2282,2052081,8419000,NA
2022-05-09,3968,2583,2054664,8419000,NA
2022-05-10,3777,3227,2057891,8419000,NA
2022-05-11,4028,3924,2061815,8419000,NA
2022-05-12,3933,3913,2065728,8419000,NA
2022-05-13,3493,3818,2069546,8419000,NA
2022-05-14,2397,3274,2072820,8419000,NA
2022-05-15,2199,2696,2075516,8419000,NA
2022-05-16,4017,2871,2078387,8419000,NA
2022-05-17,3699,3305,2081692,8419000,NA
2022-05-18,4101,3939,2085631,8419000,NA
2022-05-19,3645,3815,2089446,8419000,NA
2022-05-20,3301,3682,2093128,8419000,NA
2022-05-21,2288,3078,2096206,8419000,NA
2022-05-22,2170,2586,2098792,8419000,NA
2022-05-23,3864,2774,2101566,8419000,NA
